res1,res2,pair,ind1,ind2,roh1,roh2,roh3,roh12,roh23,roh34,ind1roh1,ind1roh2,ind1roh12,ind1roh23,ind1roh3,ind2roh1,ind2roh2,ind2roh12,ind2roh23,ind2roh3
Chandrapur,Corbett,Chandrapur-Corbett,BEN_CI2,BEN_NOR1,203933640,167764351,21440254,36169289,146324097,14769606,674364895,657438378,16926517,229909737,427528641,689133358,592060124,97073234,396388890,195671234
Chandrapur,Corbett,Chandrapur-Corbett,BEN_CI2,BEN_NOR2,263557981,228281474,88010645,35276507,140270829,33730843,674364895,657438378,16926517,229909737,427528641,872604239,770086648,102517591,315997124,454089524
Chandrapur,Kanha,Chandrapur-Kanha,BEN_CI2,BEN_CI15,191857139,153628829,44407663,38228310,109221166,22197615,674364895,657438378,16926517,229909737,427528641,558426844,440368350,118058494,313676252,126692098
Chandrapur,Kanha,Chandrapur-Kanha,BEN_CI2,BEN_CI16,245499155,213782612,66356534,31716543,147426078,31667943,674364895,657438378,16926517,229909737,427528641,941465693,865515372,75950321,260165870,605349502
Chandrapur,Kanha,Chandrapur-Kanha,BEN_CI2,BEN_CI18,169580790,131811271,31496160,37769519,100315111,11522652,674364895,657438378,16926517,229909737,427528641,531335982,416398696,114937286,280261230,136137466
Chandrapur,Kanha,Chandrapur-Kanha,BEN_CI2,BEN_CI19,121659835,80993890,,40665945,80993890,,674364895,657438378,16926517,229909737,427528641,370653731,261143653,109510078,241812071,19331582
Chandrapur,Kanha,Chandrapur-Kanha,BEN_CI2,BEN_CI3,189146057,148283319,42821890,40862738,105461429,19378399,674364895,657438378,16926517,229909737,427528641,399948004,398407865,1540139,114426239,283981626
Chandrapur,Kanha,Chandrapur-Kanha,BEN_CI2,BEN_CI4,179146016,151491193,43292370,27654823,108198823,12285466,674364895,657438378,16926517,229909737,427528641,588039664,506748544,81291120,270707157,236041387
Chandrapur,Kanha,Chandrapur-Kanha,BEN_CI2,BEN_CI5,140327809,111488358,9135719,28839451,102352639,6892178,674364895,657438378,16926517,229909737,427528641,447217937,358814659,88403278,289122614,69692045
Chandrapur,Kanha,Chandrapur-Kanha,BEN_CI2,BEN_CI6,178131395,142577354,32628886,35554041,109948468,20254715,674364895,657438378,16926517,229909737,427528641,558093435,456569955,101523480,304633087,151936868
Chandrapur,Kanha,Chandrapur-Kanha,BEN_CI2,BEN_CI7,211568332,201270189,81006032,10298143,120264157,21198096,674364895,657438378,16926517,229909737,427528641,746271387,730520258,15751129,197580294,532939964
Chandrapur,Kaziranga,Chandrapur-Kaziranga,BEN_CI2,BEN_NE1,157453788,111644153,14664880,45809635,96979273,7234310,674364895,657438378,16926517,229909737,427528641,560246780,423100976,137145804,256700947,166400029
Chandrapur,Kaziranga,Chandrapur-Kaziranga,BEN_CI2,BEN_NE2,366459890,334077339,162563400,32382551,171513939,59817301,674364895,657438378,16926517,229909737,427528641,1250511108,1174630426,75880682,233913209,940717217
Chandrapur,Kaziranga,Chandrapur-Kaziranga,BEN_CI2,BEN_NE3,302418471,270754655,113237993,31663816,157516662,53082555,674364895,657438378,16926517,229909737,427528641,1008859852,937520336,71339516,277485474,660034862
Chandrapur,Lalgarh,Chandrapur-Lalgarh,BEN_CI2,LGS1,234234546,198844273,39200816,35390273,159643457,19929922,674364895,657438378,16926517,229909737,427528641,737843728,638009894,99833834,404772144,233237750
Chandrapur,Periyar,Chandrapur-Periyar,BEN_CI2,BEN_SI5,384029727,357109290,128427356,26920437,228681934,66735678,674364895,657438378,16926517,229909737,427528641,1343835283,1299687777,44147506,344660143,955027634
Chandrapur,Ranthambore,Chandrapur-Ranthambore,BEN_CI2,BEN_NW10,362043632,337221763,144895008,24821869,192326755,75859156,674364895,657438378,16926517,229909737,427528641,1266198710,1229664069,36534641,328923565,900740504
Chandrapur,Ranthambore,Chandrapur-Ranthambore,BEN_CI2,BEN_NW11,308506905,285459882,122979467,23047023,162480415,60742572,674364895,657438378,16926517,229909737,427528641,997123987,950413379,46710608,263905963,686507416
Chandrapur,Ranthambore,Chandrapur-Ranthambore,BEN_CI2,BEN_NW12,398680733,378494959,205187792,20185774,173307167,80515584,674364895,657438378,16926517,229909737,427528641,1267506856,1231795407,35711449,227052846,1004742561
Chandrapur,Ranthambore,Chandrapur-Ranthambore,BEN_CI2,BEN_NW13,345029055,317261877,119665843,27767178,197596034,57808473,674364895,657438378,16926517,229909737,427528641,1183131254,1138285233,44846021,344174628,794110605
Chandrapur,Ranthambore,Chandrapur-Ranthambore,BEN_CI2,BEN_NW14,377851317,353479872,183283769,24371445,170196103,59291348,674364895,657438378,16926517,229909737,427528641,1235716540,1190952996,44763544,177541519,1013411477
Chandrapur,Ranthambore,Chandrapur-Ranthambore,BEN_CI2,BEN_NW17,314269223,292004715,114424597,22264508,177580118,50086971,674364895,657438378,16926517,229909737,427528641,1116321554,1085802823,30518731,256140006,829662817
Chandrapur,Ranthambore,Chandrapur-Ranthambore,BEN_CI2,BEN_NW18,411604753,387541509,191751416,24063244,195790093,71115300,674364895,657438378,16926517,229909737,427528641,1339364699,1300736006,38628693,242877521,1057858485
Chandrapur,Ranthambore,Chandrapur-Ranthambore,BEN_CI2,BEN_NW19,311510615,288236899,132129397,23273716,156107502,48111075,674364895,657438378,16926517,229909737,427528641,1081768306,1036331080,45437226,232322355,804008725
Chandrapur,Ranthambore,Chandrapur-Ranthambore,BEN_CI2,BEN_NW20,319360740,289107152,61728792,30253588,227378360,45367716,674364895,657438378,16926517,229909737,427528641,1086271749,1022278981,63992768,541693814,480585167
Chandrapur,Ranthambore,Chandrapur-Ranthambore,BEN_CI2,BEN_NW24,359098263,335322761,142841706,23775502,192481055,71364341,674364895,657438378,16926517,229909737,427528641,1159641386,1113494396,46146990,301627698,811866698
Chandrapur,Ranthambore,Chandrapur-Ranthambore,BEN_CI2,BEN_NW3,356852472,332553252,140691409,24299220,191861843,65840635,674364895,657438378,16926517,229909737,427528641,1280728709,1240123254,40605455,207797688,1032325566
Chandrapur,Ranthambore,Chandrapur-Ranthambore,BEN_CI2,BEN_NW4,356947098,336842437,179658470,20104661,157183967,53660408,674364895,657438378,16926517,229909737,427528641,1219365724,1186222475,33143249,158691252,1027531223
Chandrapur,Ranthambore,Chandrapur-Ranthambore,BEN_CI2,BEN_NW5,294140712,266041069,115907749,28099643,150133320,38272001,674364895,657438378,16926517,229909737,427528641,977809134,918585062,59224072,241966240,676618822
Chandrapur,Ranthambore,Chandrapur-Ranthambore,BEN_CI2,BEN_NW55,329852721,298778774,71926685,31073947,226852089,54317888,674364895,657438378,16926517,229909737,427528641,1131174741,1073214798,57959943,534097691,539117107
Chandrapur,Ranthambore,Chandrapur-Ranthambore,BEN_CI2,BEN_NW57,352381693,316437132,73433616,35944561,243003516,51660010,674364895,657438378,16926517,229909737,427528641,1180288036,1103120235,77167801,638361097,464759138
Chandrapur,Ranthambore,Chandrapur-Ranthambore,BEN_CI2,BEN_NW6,268849152,245042102,98019898,23807050,147022204,48534070,674364895,657438378,16926517,229909737,427528641,992143483,946435718,45707765,248527765,697907953
Chandrapur,Ranthambore,Chandrapur-Ranthambore,BEN_CI2,BEN_NW8,379023949,355242342,174747990,23781607,180494352,75980144,674364895,657438378,16926517,229909737,427528641,1196839698,1156984240,39855458,275076038,881908202
Chandrapur,Ranthambore,Chandrapur-Ranthambore,BEN_CI2,BEN_NW9,353650541,328637330,143349859,25013211,185287471,64952278,674364895,657438378,16926517,229909737,427528641,1246521228,1203200533,43320695,216389572,986810961
Chandrapur,Wayanad,Chandrapur-Wayanad,BEN_CI2,BEN_SI1,271141176,234827073,79769069,36314103,155058004,23373227,674364895,657438378,16926517,229909737,427528641,897358653,799698739,97659914,345341326,454357413
Chandrapur,Wayanad,Chandrapur-Wayanad,BEN_CI2,BEN_SI11,213338690,199668036,92981245,13670654,106686791,33607837,674364895,657438378,16926517,229909737,427528641,641166204,612648765,28517439,241001807,371646958
Chandrapur,Wayanad,Chandrapur-Wayanad,BEN_CI2,BEN_SI2,186529224,178491171,68371991,8038053,110119180,19498496,674364895,657438378,16926517,229909737,427528641,650993225,648515374,2477851,140667619,507847755
Chandrapur,Wayanad,Chandrapur-Wayanad,BEN_CI2,BEN_SI3,319881927,288630700,133849484,31251227,154781216,72114371,674364895,657438378,16926517,229909737,427528641,931565359,847325564,84239795,345974583,501350981
Chandrapur,Wayanad,Chandrapur-Wayanad,BEN_CI2,BEN_SI4,372757538,342800282,189151556,29957256,153648726,52822709,674364895,657438378,16926517,229909737,427528641,1109312253,1030580255,78731998,302255092,728325163
Chandrapur,Wayanad,Chandrapur-Wayanad,BEN_CI2,BEN_SI6,275656795,243757318,85849435,31899477,157907883,57087140,674364895,657438378,16926517,229909737,427528641,951080464,864453508,86626956,319674486,544779022
Chandrapur,Wayanad,Chandrapur-Wayanad,BEN_CI2,BEN_SI7,321450525,288923400,139148645,32527125,149774755,62273467,674364895,657438378,16926517,229909737,427528641,942430262,853584663,88845599,335397181,518187482
Chandrapur,Wayanad,Chandrapur-Wayanad,BEN_CI2,BEN_SI8,372688990,341439915,190884018,31249075,150555897,49889514,674364895,657438378,16926517,229909737,427528641,1108177315,1029030472,79146843,300308119,728722353
Chandrapur,Wayanad,Chandrapur-Wayanad,BEN_CI2,BEN_SI9,241028206,204641403,53998907,36386803,150642496,26831725,674364895,657438378,16926517,229909737,427528641,849233213,745820153,103413060,339499389,406320764
Chandrapur,Zoo,Chandrapur-Zoo,BEN_CI2,ZSB_01,215232920,182719340,59014040,32513580,123705300,15467613,674364895,657438378,16926517,229909737,427528641,723092447,635855373,87237074,256023333,379832040
Chandrapur,Zoo,Chandrapur-Zoo,BEN_CI2,ZSB_02,270557417,240206075,94331191,30351342,145874884,46951088,674364895,657438378,16926517,229909737,427528641,942790346,865053483,77736863,260820720,604232763
Chandrapur,Zoo,Chandrapur-Zoo,BEN_CI2,ZSB_03,253794762,226280116,80857650,27514646,145422466,35392584,674364895,657438378,16926517,229909737,427528641,892317758,827799945,64517813,241409256,586390689
Chandrapur,Zoo,Chandrapur-Zoo,BEN_CI2,ZSB_04,270297133,244184953,89999567,26112180,154185386,41042907,674364895,657438378,16926517,229909737,427528641,867386629,799476794,67909835,302302125,497174669
Chandrapur,Zoo,Chandrapur-Zoo,BEN_CI2,ZSB_05,264954750,234046765,99909746,30907985,134137019,52098953,674364895,657438378,16926517,229909737,427528641,864922054,784467789,80454265,246263826,538203963
Corbett,Chandrapur,Corbett-Chandrapur,BEN_NOR1,BEN_CI2,203933640,167764351,21440254,36169289,146324097,14769606,689133358,592060124,97073234,396388890,195671234,674364895,657438378,16926517,229909737,427528641
Corbett,Chandrapur,Corbett-Chandrapur,BEN_NOR2,BEN_CI2,263557981,228281474,88010645,35276507,140270829,33730843,872604239,770086648,102517591,315997124,454089524,674364895,657438378,16926517,229909737,427528641
Corbett,Corbett,Corbett-Corbett,BEN_NOR1,BEN_NOR2,291280902,217339114,36035016,73941788,181304098,30487822,689133358,592060124,97073234,396388890,195671234,872604239,770086648,102517591,315997124,454089524
Corbett,Corbett,Corbett-Corbett,BEN_NOR2,BEN_NOR1,291280902,217339114,36035016,73941788,181304098,30487822,872604239,770086648,102517591,315997124,454089524,689133358,592060124,97073234,396388890,195671234
Corbett,Kanha,Corbett-Kanha,BEN_NOR1,BEN_CI15,175690402,114653964,10976104,61036438,103677860,5771791,689133358,592060124,97073234,396388890,195671234,558426844,440368350,118058494,313676252,126692098
Corbett,Kanha,Corbett-Kanha,BEN_NOR1,BEN_CI16,287861895,221139666,39845061,66722229,181294605,31258052,689133358,592060124,97073234,396388890,195671234,941465693,865515372,75950321,260165870,605349502
Corbett,Kanha,Corbett-Kanha,BEN_NOR1,BEN_CI18,161954957,100696560,3515956,61258397,97180604,3515956,689133358,592060124,97073234,396388890,195671234,531335982,416398696,114937286,280261230,136137466
Corbett,Kanha,Corbett-Kanha,BEN_NOR1,BEN_CI19,120191842,66460814,,53731028,66460814,,689133358,592060124,97073234,396388890,195671234,370653731,261143653,109510078,241812071,19331582
Corbett,Kanha,Corbett-Kanha,BEN_NOR1,BEN_CI3,210466166,149501939,30930775,60964227,118571164,18101785,689133358,592060124,97073234,396388890,195671234,399948004,398407865,1540139,114426239,283981626
Corbett,Kanha,Corbett-Kanha,BEN_NOR1,BEN_CI4,183199620,132392936,10938027,50806684,121454909,10938027,689133358,592060124,97073234,396388890,195671234,588039664,506748544,81291120,270707157,236041387
Corbett,Kanha,Corbett-Kanha,BEN_NOR1,BEN_CI5,140118467,90120669,8038214,49997798,82082455,8038214,689133358,592060124,97073234,396388890,195671234,447217937,358814659,88403278,289122614,69692045
Corbett,Kanha,Corbett-Kanha,BEN_NOR1,BEN_CI6,176199988,121874911,12657753,54325077,109217158,8484743,689133358,592060124,97073234,396388890,195671234,558093435,456569955,101523480,304633087,151936868
Corbett,Kanha,Corbett-Kanha,BEN_NOR1,BEN_CI7,212920689,175950215,38541320,36970474,137408895,26602378,689133358,592060124,97073234,396388890,195671234,746271387,730520258,15751129,197580294,532939964
Corbett,Kanha,Corbett-Kanha,BEN_NOR2,BEN_CI15,206985494,134119677,2461778,72865817,131657899,2461778,872604239,770086648,102517591,315997124,454089524,558426844,440368350,118058494,313676252,126692098
Corbett,Kanha,Corbett-Kanha,BEN_NOR2,BEN_CI16,367169640,299747242,112180685,67422398,187566557,42454843,872604239,770086648,102517591,315997124,454089524,941465693,865515372,75950321,260165870,605349502
Corbett,Kanha,Corbett-Kanha,BEN_NOR2,BEN_CI18,225606260,159141817,40497803,66464443,118644014,9584612,872604239,770086648,102517591,315997124,454089524,531335982,416398696,114937286,280261230,136137466
Corbett,Kanha,Corbett-Kanha,BEN_NOR2,BEN_CI19,152605104,92590898,4359991,60014206,88230907,4359991,872604239,770086648,102517591,315997124,454089524,370653731,261143653,109510078,241812071,19331582
Corbett,Kanha,Corbett-Kanha,BEN_NOR2,BEN_CI3,242910615,172911454,36233491,69999161,136677963,16259339,872604239,770086648,102517591,315997124,454089524,399948004,398407865,1540139,114426239,283981626
Corbett,Kanha,Corbett-Kanha,BEN_NOR2,BEN_CI4,227242234,168451948,25653299,58790286,142798649,13419539,872604239,770086648,102517591,315997124,454089524,588039664,506748544,81291120,270707157,236041387
Corbett,Kanha,Corbett-Kanha,BEN_NOR2,BEN_CI5,175720271,122503780,14304805,53216491,108198975,11951242,872604239,770086648,102517591,315997124,454089524,447217937,358814659,88403278,289122614,69692045
Corbett,Kanha,Corbett-Kanha,BEN_NOR2,BEN_CI6,205708146,141542568,13106353,64165578,128436215,10990161,872604239,770086648,102517591,315997124,454089524,558093435,456569955,101523480,304633087,151936868
Corbett,Kanha,Corbett-Kanha,BEN_NOR2,BEN_CI7,265825068,225378539,64888286,40446529,160490253,40279568,872604239,770086648,102517591,315997124,454089524,746271387,730520258,15751129,197580294,532939964
Corbett,Kaziranga,Corbett-Kaziranga,BEN_NOR1,BEN_NE1,174596929,105624963,13473864,68971966,92151099,13473864,689133358,592060124,97073234,396388890,195671234,560246780,423100976,137145804,256700947,166400029
Corbett,Kaziranga,Corbett-Kaziranga,BEN_NOR1,BEN_NE2,392188392,313398408,84965550,78789984,228432858,65100765,689133358,592060124,97073234,396388890,195671234,1250511108,1174630426,75880682,233913209,940717217
Corbett,Kaziranga,Corbett-Kaziranga,BEN_NOR1,BEN_NE3,318847351,249233970,56393720,69613381,192840250,39722514,689133358,592060124,97073234,396388890,195671234,1008859852,937520336,71339516,277485474,660034862
Corbett,Kaziranga,Corbett-Kaziranga,BEN_NOR2,BEN_NE1,214446627,141741032,31065330,72705595,110675702,12628942,872604239,770086648,102517591,315997124,454089524,560246780,423100976,137145804,256700947,166400029
Corbett,Kaziranga,Corbett-Kaziranga,BEN_NOR2,BEN_NE2,462502665,376626199,158680330,85876466,217945869,61713322,872604239,770086648,102517591,315997124,454089524,1250511108,1174630426,75880682,233913209,940717217
Corbett,Kaziranga,Corbett-Kaziranga,BEN_NOR2,BEN_NE3,365093607,287584843,87017266,77508764,200567577,52419659,872604239,770086648,102517591,315997124,454089524,1008859852,937520336,71339516,277485474,660034862
Corbett,Lalgarh,Corbett-Lalgarh,BEN_NOR1,LGS1,222547604,152180749,10922112,70366855,141258637,10922112,689133358,592060124,97073234,396388890,195671234,737843728,638009894,99833834,404772144,233237750
Corbett,Lalgarh,Corbett-Lalgarh,BEN_NOR2,LGS1,294079062,219971396,40825717,74107666,179145679,33116008,872604239,770086648,102517591,315997124,454089524,737843728,638009894,99833834,404772144,233237750
Corbett,Periyar,Corbett-Periyar,BEN_NOR1,BEN_SI5,404295795,331597242,69207018,72698553,262390224,58483729,689133358,592060124,97073234,396388890,195671234,1343835283,1299687777,44147506,344660143,955027634
Corbett,Periyar,Corbett-Periyar,BEN_NOR2,BEN_SI5,506943188,422962678,149626748,83980510,273335930,93376252,872604239,770086648,102517591,315997124,454089524,1343835283,1299687777,44147506,344660143,955027634
Corbett,Ranthambore,Corbett-Ranthambore,BEN_NOR1,BEN_NW10,374021723,304128456,61403022,69893267,242725434,52290617,689133358,592060124,97073234,396388890,195671234,1266198710,1229664069,36534641,328923565,900740504
Corbett,Ranthambore,Corbett-Ranthambore,BEN_NOR1,BEN_NW11,302791235,242767310,50171821,60023925,192595489,39587252,689133358,592060124,97073234,396388890,195671234,997123987,950413379,46710608,263905963,686507416
Corbett,Ranthambore,Corbett-Ranthambore,BEN_NOR1,BEN_NW12,393922808,325462952,78926299,68459856,246536653,60187875,689133358,592060124,97073234,396388890,195671234,1267506856,1231795407,35711449,227052846,1004742561
Corbett,Ranthambore,Corbett-Ranthambore,BEN_NOR1,BEN_NW13,353827385,285084317,57846240,68743068,227238077,45047858,689133358,592060124,97073234,396388890,195671234,1183131254,1138285233,44846021,344174628,794110605
Corbett,Ranthambore,Corbett-Ranthambore,BEN_NOR1,BEN_NW14,386853407,320611130,84942253,66242277,235668877,58211723,689133358,592060124,97073234,396388890,195671234,1235716540,1190952996,44763544,177541519,1013411477
Corbett,Ranthambore,Corbett-Ranthambore,BEN_NOR1,BEN_NW17,337005987,275224906,52530849,61781081,222694057,42289023,689133358,592060124,97073234,396388890,195671234,1116321554,1085802823,30518731,256140006,829662817
Corbett,Ranthambore,Corbett-Ranthambore,BEN_NOR1,BEN_NW18,422117639,354647955,109040149,67469684,245607806,73828969,689133358,592060124,97073234,396388890,195671234,1339364699,1300736006,38628693,242877521,1057858485
Corbett,Ranthambore,Corbett-Ranthambore,BEN_NOR1,BEN_NW19,328872692,264031266,58975420,64841426,205055846,40367719,689133358,592060124,97073234,396388890,195671234,1081768306,1036331080,45437226,232322355,804008725
Corbett,Ranthambore,Corbett-Ranthambore,BEN_NOR1,BEN_NW20,335309553,261114854,32708727,74194699,228406127,32708727,689133358,592060124,97073234,396388890,195671234,1086271749,1022278981,63992768,541693814,480585167
Corbett,Ranthambore,Corbett-Ranthambore,BEN_NOR1,BEN_NW24,356261902,284800628,51487648,71461274,233312980,43439943,689133358,592060124,97073234,396388890,195671234,1159641386,1113494396,46146990,301627698,811866698
Corbett,Ranthambore,Corbett-Ranthambore,BEN_NOR1,BEN_NW3,395086973,326896924,87331729,68190049,239565195,58318114,689133358,592060124,97073234,396388890,195671234,1280728709,1240123254,40605455,207797688,1032325566
Corbett,Ranthambore,Corbett-Ranthambore,BEN_NOR1,BEN_NW4,364161239,300995083,77471826,63166156,223523257,52775350,689133358,592060124,97073234,396388890,195671234,1219365724,1186222475,33143249,158691252,1027531223
Corbett,Ranthambore,Corbett-Ranthambore,BEN_NOR1,BEN_NW5,292531779,226077402,49906627,66454377,176170775,31331679,689133358,592060124,97073234,396388890,195671234,977809134,918585062,59224072,241966240,676618822
Corbett,Ranthambore,Corbett-Ranthambore,BEN_NOR1,BEN_NW55,338667370,265529533,32069181,73137837,233460352,32069181,689133358,592060124,97073234,396388890,195671234,1131174741,1073214798,57959943,534097691,539117107
Corbett,Ranthambore,Corbett-Ranthambore,BEN_NOR1,BEN_NW57,353897381,266573675,18933560,87323706,247640115,18933560,689133358,592060124,97073234,396388890,195671234,1180288036,1103120235,77167801,638361097,464759138
Corbett,Ranthambore,Corbett-Ranthambore,BEN_NOR1,BEN_NW6,311152195,255312322,63031998,55839873,192280324,49623665,689133358,592060124,97073234,396388890,195671234,992143483,946435718,45707765,248527765,697907953
Corbett,Ranthambore,Corbett-Ranthambore,BEN_NOR1,BEN_NW8,363092456,297517660,67641984,65574796,229875676,51699906,689133358,592060124,97073234,396388890,195671234,1196839698,1156984240,39855458,275076038,881908202
Corbett,Ranthambore,Corbett-Ranthambore,BEN_NOR1,BEN_NW9,373841106,304188822,76145452,69652284,228043370,63892297,689133358,592060124,97073234,396388890,195671234,1246521228,1203200533,43320695,216389572,986810961
Corbett,Ranthambore,Corbett-Ranthambore,BEN_NOR2,BEN_NW10,491446895,413073805,159641043,78373090,253432762,96747129,872604239,770086648,102517591,315997124,454089524,1266198710,1229664069,36534641,328923565,900740504
Corbett,Ranthambore,Corbett-Ranthambore,BEN_NOR2,BEN_NW11,370751616,304726199,118697081,66025417,186029118,61154819,872604239,770086648,102517591,315997124,454089524,997123987,950413379,46710608,263905963,686507416
Corbett,Ranthambore,Corbett-Ranthambore,BEN_NOR2,BEN_NW12,494524811,422125720,209282756,72399091,212842964,67409833,872604239,770086648,102517591,315997124,454089524,1267506856,1231795407,35711449,227052846,1004742561
Corbett,Ranthambore,Corbett-Ranthambore,BEN_NOR2,BEN_NW13,475573557,405177382,175924501,70396175,229252881,99981354,872604239,770086648,102517591,315997124,454089524,1183131254,1138285233,44846021,344174628,794110605
Corbett,Ranthambore,Corbett-Ranthambore,BEN_NOR2,BEN_NW14,479663082,406349990,203068190,73313092,203281800,63473636,872604239,770086648,102517591,315997124,454089524,1235716540,1190952996,44763544,177541519,1013411477
Corbett,Ranthambore,Corbett-Ranthambore,BEN_NOR2,BEN_NW17,415523724,348010999,138561422,67512725,209449577,63402699,872604239,770086648,102517591,315997124,454089524,1116321554,1085802823,30518731,256140006,829662817
Corbett,Ranthambore,Corbett-Ranthambore,BEN_NOR2,BEN_NW18,539511186,463526030,223326806,75985156,240199224,92321181,872604239,770086648,102517591,315997124,454089524,1339364699,1300736006,38628693,242877521,1057858485
Corbett,Ranthambore,Corbett-Ranthambore,BEN_NOR2,BEN_NW19,407453343,338709643,132713976,68743700,205995667,56652694,872604239,770086648,102517591,315997124,454089524,1081768306,1036331080,45437226,232322355,804008725
Corbett,Ranthambore,Corbett-Ranthambore,BEN_NOR2,BEN_NW20,447142532,370283523,102841512,76859009,267442011,66034090,872604239,770086648,102517591,315997124,454089524,1086271749,1022278981,63992768,541693814,480585167
Corbett,Ranthambore,Corbett-Ranthambore,BEN_NOR2,BEN_NW24,437185644,362150507,132124026,75035137,230026481,72438751,872604239,770086648,102517591,315997124,454089524,1159641386,1113494396,46146990,301627698,811866698
Corbett,Ranthambore,Corbett-Ranthambore,BEN_NOR2,BEN_NW3,515178902,441456009,232923971,73722893,208532038,68782170,872604239,770086648,102517591,315997124,454089524,1280728709,1240123254,40605455,207797688,1032325566
Corbett,Ranthambore,Corbett-Ranthambore,BEN_NOR2,BEN_NW4,495339143,431578260,237861211,63760883,193717049,57647042,872604239,770086648,102517591,315997124,454089524,1219365724,1186222475,33143249,158691252,1027531223
Corbett,Ranthambore,Corbett-Ranthambore,BEN_NOR2,BEN_NW5,397515209,331339881,138875699,66175328,192464182,59965866,872604239,770086648,102517591,315997124,454089524,977809134,918585062,59224072,241966240,676618822
Corbett,Ranthambore,Corbett-Ranthambore,BEN_NOR2,BEN_NW55,449629250,371947721,115902723,77681529,256044998,76258392,872604239,770086648,102517591,315997124,454089524,1131174741,1073214798,57959943,534097691,539117107
Corbett,Ranthambore,Corbett-Ranthambore,BEN_NOR2,BEN_NW57,467390300,377147269,96504333,90243031,280642936,60507387,872604239,770086648,102517591,315997124,454089524,1180288036,1103120235,77167801,638361097,464759138
Corbett,Ranthambore,Corbett-Ranthambore,BEN_NOR2,BEN_NW6,393363806,333404869,145870078,59958937,187534791,65289357,872604239,770086648,102517591,315997124,454089524,992143483,946435718,45707765,248527765,697907953
Corbett,Ranthambore,Corbett-Ranthambore,BEN_NOR2,BEN_NW8,460575623,389691238,157522566,70884385,232168672,77984590,872604239,770086648,102517591,315997124,454089524,1196839698,1156984240,39855458,275076038,881908202
Corbett,Ranthambore,Corbett-Ranthambore,BEN_NOR2,BEN_NW9,484165805,411161889,189123305,73003916,222038584,58447929,872604239,770086648,102517591,315997124,454089524,1246521228,1203200533,43320695,216389572,986810961
Corbett,Wayanad,Corbett-Wayanad,BEN_NOR1,BEN_SI1,280816684,209661691,34254520,71154993,175407171,24625993,689133358,592060124,97073234,396388890,195671234,897358653,799698739,97659914,345341326,454357413
Corbett,Wayanad,Corbett-Wayanad,BEN_NOR1,BEN_SI11,218752137,178644101,32015455,40108036,146628646,27777753,689133358,592060124,97073234,396388890,195671234,641166204,612648765,28517439,241001807,371646958
Corbett,Wayanad,Corbett-Wayanad,BEN_NOR1,BEN_SI2,201259362,169971769,41008872,31287593,128962897,28106419,689133358,592060124,97073234,396388890,195671234,650993225,648515374,2477851,140667619,507847755
Corbett,Wayanad,Corbett-Wayanad,BEN_NOR1,BEN_SI3,279421651,208792871,27142768,70628780,181650103,19037707,689133358,592060124,97073234,396388890,195671234,931565359,847325564,84239795,345974583,501350981
Corbett,Wayanad,Corbett-Wayanad,BEN_NOR1,BEN_SI4,340300854,267530014,65929488,72770840,201600526,56118526,689133358,592060124,97073234,396388890,195671234,1109312253,1030580255,78731998,302255092,728325163
Corbett,Wayanad,Corbett-Wayanad,BEN_NOR1,BEN_SI6,285198788,216207478,33531903,68991310,182675575,25484251,689133358,592060124,97073234,396388890,195671234,951080464,864453508,86626956,319674486,544779022
Corbett,Wayanad,Corbett-Wayanad,BEN_NOR1,BEN_SI7,283377514,211126988,29890870,72250526,181236118,17582846,689133358,592060124,97073234,396388890,195671234,942430262,853584663,88845599,335397181,518187482
Corbett,Wayanad,Corbett-Wayanad,BEN_NOR1,BEN_SI8,339028258,265685868,64027203,73342390,201658665,49303244,689133358,592060124,97073234,396388890,195671234,1108177315,1029030472,79146843,300308119,728722353
Corbett,Wayanad,Corbett-Wayanad,BEN_NOR1,BEN_SI9,258656593,189154215,36943145,69502378,152211070,31653345,689133358,592060124,97073234,396388890,195671234,849233213,745820153,103413060,339499389,406320764
Corbett,Wayanad,Corbett-Wayanad,BEN_NOR2,BEN_SI1,362302244,284628891,101884248,77673353,182744643,48040106,872604239,770086648,102517591,315997124,454089524,897358653,799698739,97659914,345341326,454357413
Corbett,Wayanad,Corbett-Wayanad,BEN_NOR2,BEN_SI11,240099614,197020145,68944005,43079469,128076140,36722509,872604239,770086648,102517591,315997124,454089524,641166204,612648765,28517439,241001807,371646958
Corbett,Wayanad,Corbett-Wayanad,BEN_NOR2,BEN_SI2,247971062,216566419,86928923,31404643,129637496,54055376,872604239,770086648,102517591,315997124,454089524,650993225,648515374,2477851,140667619,507847755
Corbett,Wayanad,Corbett-Wayanad,BEN_NOR2,BEN_SI3,356939718,282027623,97720875,74912095,184306748,55518997,872604239,770086648,102517591,315997124,454089524,931565359,847325564,84239795,345974583,501350981
Corbett,Wayanad,Corbett-Wayanad,BEN_NOR2,BEN_SI4,428303161,349252367,127029976,79050794,222222391,47812420,872604239,770086648,102517591,315997124,454089524,1109312253,1030580255,78731998,302255092,728325163
Corbett,Wayanad,Corbett-Wayanad,BEN_NOR2,BEN_SI6,386988103,313304904,135136480,73683199,178168424,58644519,872604239,770086648,102517591,315997124,454089524,951080464,864453508,86626956,319674486,544779022
Corbett,Wayanad,Corbett-Wayanad,BEN_NOR2,BEN_SI7,361672999,284316204,98494139,77356795,185822065,51645219,872604239,770086648,102517591,315997124,454089524,942430262,853584663,88845599,335397181,518187482
Corbett,Wayanad,Corbett-Wayanad,BEN_NOR2,BEN_SI8,427370233,347718268,130475646,79651965,217242622,50976035,872604239,770086648,102517591,315997124,454089524,1108177315,1029030472,79146843,300308119,728722353
Corbett,Wayanad,Corbett-Wayanad,BEN_NOR2,BEN_SI9,346113453,270329680,86561486,75783773,183768194,45678554,872604239,770086648,102517591,315997124,454089524,849233213,745820153,103413060,339499389,406320764
Corbett,Zoo,Corbett-Zoo,BEN_NOR1,ZSB_01,230617595,171650420,39057173,58967175,132593247,28432532,689133358,592060124,97073234,396388890,195671234,723092447,635855373,87237074,256023333,379832040
Corbett,Zoo,Corbett-Zoo,BEN_NOR1,ZSB_02,302492641,239466456,43616013,63026185,195850443,34413613,689133358,592060124,97073234,396388890,195671234,942790346,865053483,77736863,260820720,604232763
Corbett,Zoo,Corbett-Zoo,BEN_NOR1,ZSB_03,270300556,210594057,43260142,59706499,167333915,27583625,689133358,592060124,97073234,396388890,195671234,892317758,827799945,64517813,241409256,586390689
Corbett,Zoo,Corbett-Zoo,BEN_NOR1,ZSB_04,258921093,200260995,27913326,58660098,172347669,19099951,689133358,592060124,97073234,396388890,195671234,867386629,799476794,67909835,302302125,497174669
Corbett,Zoo,Corbett-Zoo,BEN_NOR1,ZSB_05,269024898,202832308,38343431,66192590,164488877,29262458,689133358,592060124,97073234,396388890,195671234,864922054,784467789,80454265,246263826,538203963
Corbett,Zoo,Corbett-Zoo,BEN_NOR2,ZSB_01,281841319,217336276,69632501,64505043,147703775,26267879,872604239,770086648,102517591,315997124,454089524,723092447,635855373,87237074,256023333,379832040
Corbett,Zoo,Corbett-Zoo,BEN_NOR2,ZSB_02,354798342,279593678,105942709,75204664,173650969,51185935,872604239,770086648,102517591,315997124,454089524,942790346,865053483,77736863,260820720,604232763
Corbett,Zoo,Corbett-Zoo,BEN_NOR2,ZSB_03,337893686,271829676,99046942,66064010,172782734,42468058,872604239,770086648,102517591,315997124,454089524,892317758,827799945,64517813,241409256,586390689
Corbett,Zoo,Corbett-Zoo,BEN_NOR2,ZSB_04,311629266,243724128,72794682,67905138,170929446,42134549,872604239,770086648,102517591,315997124,454089524,867386629,799476794,67909835,302302125,497174669
Corbett,Zoo,Corbett-Zoo,BEN_NOR2,ZSB_05,352948457,281779011,120852277,71169446,160926734,38020690,872604239,770086648,102517591,315997124,454089524,864922054,784467789,80454265,246263826,538203963
Kanha,Chandrapur,Kanha-Chandrapur,BEN_CI15,BEN_CI2,191857139,153628829,44407663,38228310,109221166,22197615,558426844,440368350,118058494,313676252,126692098,674364895,657438378,16926517,229909737,427528641
Kanha,Chandrapur,Kanha-Chandrapur,BEN_CI16,BEN_CI2,245499155,213782612,66356534,31716543,147426078,31667943,941465693,865515372,75950321,260165870,605349502,674364895,657438378,16926517,229909737,427528641
Kanha,Chandrapur,Kanha-Chandrapur,BEN_CI18,BEN_CI2,169580790,131811271,31496160,37769519,100315111,11522652,531335982,416398696,114937286,280261230,136137466,674364895,657438378,16926517,229909737,427528641
Kanha,Chandrapur,Kanha-Chandrapur,BEN_CI19,BEN_CI2,121659835,80993890,,40665945,80993890,,370653731,261143653,109510078,241812071,19331582,674364895,657438378,16926517,229909737,427528641
Kanha,Chandrapur,Kanha-Chandrapur,BEN_CI3,BEN_CI2,189146057,148283319,42821890,40862738,105461429,19378399,399948004,398407865,1540139,114426239,283981626,674364895,657438378,16926517,229909737,427528641
Kanha,Chandrapur,Kanha-Chandrapur,BEN_CI4,BEN_CI2,179146016,151491193,43292370,27654823,108198823,12285466,588039664,506748544,81291120,270707157,236041387,674364895,657438378,16926517,229909737,427528641
Kanha,Chandrapur,Kanha-Chandrapur,BEN_CI5,BEN_CI2,140327809,111488358,9135719,28839451,102352639,6892178,447217937,358814659,88403278,289122614,69692045,674364895,657438378,16926517,229909737,427528641
Kanha,Chandrapur,Kanha-Chandrapur,BEN_CI6,BEN_CI2,178131395,142577354,32628886,35554041,109948468,20254715,558093435,456569955,101523480,304633087,151936868,674364895,657438378,16926517,229909737,427528641
Kanha,Chandrapur,Kanha-Chandrapur,BEN_CI7,BEN_CI2,211568332,201270189,81006032,10298143,120264157,21198096,746271387,730520258,15751129,197580294,532939964,674364895,657438378,16926517,229909737,427528641
Kanha,Corbett,Kanha-Corbett,BEN_CI15,BEN_NOR1,175690402,114653964,10976104,61036438,103677860,5771791,558426844,440368350,118058494,313676252,126692098,689133358,592060124,97073234,396388890,195671234
Kanha,Corbett,Kanha-Corbett,BEN_CI15,BEN_NOR2,206985494,134119677,2461778,72865817,131657899,2461778,558426844,440368350,118058494,313676252,126692098,872604239,770086648,102517591,315997124,454089524
Kanha,Corbett,Kanha-Corbett,BEN_CI16,BEN_NOR1,287861895,221139666,39845061,66722229,181294605,31258052,941465693,865515372,75950321,260165870,605349502,689133358,592060124,97073234,396388890,195671234
Kanha,Corbett,Kanha-Corbett,BEN_CI16,BEN_NOR2,367169640,299747242,112180685,67422398,187566557,42454843,941465693,865515372,75950321,260165870,605349502,872604239,770086648,102517591,315997124,454089524
Kanha,Corbett,Kanha-Corbett,BEN_CI18,BEN_NOR1,161954957,100696560,3515956,61258397,97180604,3515956,531335982,416398696,114937286,280261230,136137466,689133358,592060124,97073234,396388890,195671234
Kanha,Corbett,Kanha-Corbett,BEN_CI18,BEN_NOR2,225606260,159141817,40497803,66464443,118644014,9584612,531335982,416398696,114937286,280261230,136137466,872604239,770086648,102517591,315997124,454089524
Kanha,Corbett,Kanha-Corbett,BEN_CI19,BEN_NOR1,120191842,66460814,,53731028,66460814,,370653731,261143653,109510078,241812071,19331582,689133358,592060124,97073234,396388890,195671234
Kanha,Corbett,Kanha-Corbett,BEN_CI19,BEN_NOR2,152605104,92590898,4359991,60014206,88230907,4359991,370653731,261143653,109510078,241812071,19331582,872604239,770086648,102517591,315997124,454089524
Kanha,Corbett,Kanha-Corbett,BEN_CI3,BEN_NOR1,210466166,149501939,30930775,60964227,118571164,18101785,399948004,398407865,1540139,114426239,283981626,689133358,592060124,97073234,396388890,195671234
Kanha,Corbett,Kanha-Corbett,BEN_CI3,BEN_NOR2,242910615,172911454,36233491,69999161,136677963,16259339,399948004,398407865,1540139,114426239,283981626,872604239,770086648,102517591,315997124,454089524
Kanha,Corbett,Kanha-Corbett,BEN_CI4,BEN_NOR1,183199620,132392936,10938027,50806684,121454909,10938027,588039664,506748544,81291120,270707157,236041387,689133358,592060124,97073234,396388890,195671234
Kanha,Corbett,Kanha-Corbett,BEN_CI4,BEN_NOR2,227242234,168451948,25653299,58790286,142798649,13419539,588039664,506748544,81291120,270707157,236041387,872604239,770086648,102517591,315997124,454089524
Kanha,Corbett,Kanha-Corbett,BEN_CI5,BEN_NOR1,140118467,90120669,8038214,49997798,82082455,8038214,447217937,358814659,88403278,289122614,69692045,689133358,592060124,97073234,396388890,195671234
Kanha,Corbett,Kanha-Corbett,BEN_CI5,BEN_NOR2,175720271,122503780,14304805,53216491,108198975,11951242,447217937,358814659,88403278,289122614,69692045,872604239,770086648,102517591,315997124,454089524
Kanha,Corbett,Kanha-Corbett,BEN_CI6,BEN_NOR1,176199988,121874911,12657753,54325077,109217158,8484743,558093435,456569955,101523480,304633087,151936868,689133358,592060124,97073234,396388890,195671234
Kanha,Corbett,Kanha-Corbett,BEN_CI6,BEN_NOR2,205708146,141542568,13106353,64165578,128436215,10990161,558093435,456569955,101523480,304633087,151936868,872604239,770086648,102517591,315997124,454089524
Kanha,Corbett,Kanha-Corbett,BEN_CI7,BEN_NOR1,212920689,175950215,38541320,36970474,137408895,26602378,746271387,730520258,15751129,197580294,532939964,689133358,592060124,97073234,396388890,195671234
Kanha,Corbett,Kanha-Corbett,BEN_CI7,BEN_NOR2,265825068,225378539,64888286,40446529,160490253,40279568,746271387,730520258,15751129,197580294,532939964,872604239,770086648,102517591,315997124,454089524
Kanha,Kanha,Kanha-Kanha,BEN_CI15,BEN_CI16,236994884,169410780,21518381,67584104,147892399,14722644,558426844,440368350,118058494,313676252,126692098,941465693,865515372,75950321,260165870,605349502
Kanha,Kanha,Kanha-Kanha,BEN_CI15,BEN_CI18,161816123,104891938,9676540,56924185,95215398,7489808,558426844,440368350,118058494,313676252,126692098,531335982,416398696,114937286,280261230,136137466
Kanha,Kanha,Kanha-Kanha,BEN_CI15,BEN_CI19,118221709,64427113,2331035,53794596,62096078,2331035,558426844,440368350,118058494,313676252,126692098,370653731,261143653,109510078,241812071,19331582
Kanha,Kanha,Kanha-Kanha,BEN_CI15,BEN_CI3,183121213,124088051,25344479,59033162,98743572,10356189,558426844,440368350,118058494,313676252,126692098,399948004,398407865,1540139,114426239,283981626
Kanha,Kanha,Kanha-Kanha,BEN_CI15,BEN_CI4,192590644,141251026,24171410,51339618,117079616,12256767,558426844,440368350,118058494,313676252,126692098,588039664,506748544,81291120,270707157,236041387
Kanha,Kanha,Kanha-Kanha,BEN_CI15,BEN_CI5,132571592,87177891,,45393701,87177891,,558426844,440368350,118058494,313676252,126692098,447217937,358814659,88403278,289122614,69692045
Kanha,Kanha,Kanha-Kanha,BEN_CI15,BEN_CI6,217337252,157600926,31984510,59736326,125616416,14671086,558426844,440368350,118058494,313676252,126692098,558093435,456569955,101523480,304633087,151936868
Kanha,Kanha,Kanha-Kanha,BEN_CI15,BEN_CI7,193589896,154323499,32647683,39266397,121675816,14142121,558426844,440368350,118058494,313676252,126692098,746271387,730520258,15751129,197580294,532939964
Kanha,Kanha,Kanha-Kanha,BEN_CI16,BEN_CI15,236994884,169410780,21518381,67584104,147892399,14722644,941465693,865515372,75950321,260165870,605349502,558426844,440368350,118058494,313676252,126692098
Kanha,Kanha,Kanha-Kanha,BEN_CI16,BEN_CI18,241417614,178484318,34632127,62933296,143852191,20940891,941465693,865515372,75950321,260165870,605349502,531335982,416398696,114937286,280261230,136137466
Kanha,Kanha,Kanha-Kanha,BEN_CI16,BEN_CI19,153554123,94359167,4810874,59194956,89548293,4810874,941465693,865515372,75950321,260165870,605349502,370653731,261143653,109510078,241812071,19331582
Kanha,Kanha,Kanha-Kanha,BEN_CI16,BEN_CI3,269045648,201835007,59856202,67210641,141978805,23806838,941465693,865515372,75950321,260165870,605349502,399948004,398407865,1540139,114426239,283981626
Kanha,Kanha,Kanha-Kanha,BEN_CI16,BEN_CI4,272110246,218173785,74728696,53936461,143445089,29053522,941465693,865515372,75950321,260165870,605349502,588039664,506748544,81291120,270707157,236041387
Kanha,Kanha,Kanha-Kanha,BEN_CI16,BEN_CI5,198726799,146126025,13178661,52600774,132947364,10693363,941465693,865515372,75950321,260165870,605349502,447217937,358814659,88403278,289122614,69692045
Kanha,Kanha,Kanha-Kanha,BEN_CI16,BEN_CI6,242600243,180351690,44349425,62248553,136002265,22070368,941465693,865515372,75950321,260165870,605349502,558093435,456569955,101523480,304633087,151936868
Kanha,Kanha,Kanha-Kanha,BEN_CI16,BEN_CI7,367511716,339427017,193637967,28084699,145789050,53651675,941465693,865515372,75950321,260165870,605349502,746271387,730520258,15751129,197580294,532939964
Kanha,Kanha,Kanha-Kanha,BEN_CI18,BEN_CI15,161816123,104891938,9676540,56924185,95215398,7489808,531335982,416398696,114937286,280261230,136137466,558426844,440368350,118058494,313676252,126692098
Kanha,Kanha,Kanha-Kanha,BEN_CI18,BEN_CI16,241417614,178484318,34632127,62933296,143852191,20940891,531335982,416398696,114937286,280261230,136137466,941465693,865515372,75950321,260165870,605349502
Kanha,Kanha,Kanha-Kanha,BEN_CI18,BEN_CI19,117814751,63971767,1689665,53842984,62282102,1689665,531335982,416398696,114937286,280261230,136137466,370653731,261143653,109510078,241812071,19331582
Kanha,Kanha,Kanha-Kanha,BEN_CI18,BEN_CI3,162024513,105405417,18277106,56619096,87128311,7491106,531335982,416398696,114937286,280261230,136137466,399948004,398407865,1540139,114426239,283981626
Kanha,Kanha,Kanha-Kanha,BEN_CI18,BEN_CI4,252619174,195180939,64501942,57438235,130678997,25431595,531335982,416398696,114937286,280261230,136137466,588039664,506748544,81291120,270707157,236041387
Kanha,Kanha,Kanha-Kanha,BEN_CI18,BEN_CI5,114137811,69746303,1113803,44391508,68632500,1113803,531335982,416398696,114937286,280261230,136137466,447217937,358814659,88403278,289122614,69692045
Kanha,Kanha,Kanha-Kanha,BEN_CI18,BEN_CI6,166645078,111158737,5503268,55486341,105655469,5503268,531335982,416398696,114937286,280261230,136137466,558093435,456569955,101523480,304633087,151936868
Kanha,Kanha,Kanha-Kanha,BEN_CI18,BEN_CI7,179854971,139638325,25610835,40216646,114027490,18345877,531335982,416398696,114937286,280261230,136137466,746271387,730520258,15751129,197580294,532939964
Kanha,Kanha,Kanha-Kanha,BEN_CI19,BEN_CI15,118221709,64427113,2331035,53794596,62096078,2331035,370653731,261143653,109510078,241812071,19331582,558426844,440368350,118058494,313676252,126692098
Kanha,Kanha,Kanha-Kanha,BEN_CI19,BEN_CI16,153554123,94359167,4810874,59194956,89548293,4810874,370653731,261143653,109510078,241812071,19331582,941465693,865515372,75950321,260165870,605349502
Kanha,Kanha,Kanha-Kanha,BEN_CI19,BEN_CI18,117814751,63971767,1689665,53842984,62282102,1689665,370653731,261143653,109510078,241812071,19331582,531335982,416398696,114937286,280261230,136137466
Kanha,Kanha,Kanha-Kanha,BEN_CI19,BEN_CI3,117152356,64146661,1259335,53005695,62887326,1259335,370653731,261143653,109510078,241812071,19331582,399948004,398407865,1540139,114426239,283981626
Kanha,Kanha,Kanha-Kanha,BEN_CI19,BEN_CI4,115695637,65049551,1689665,50646086,63359886,1689665,370653731,261143653,109510078,241812071,19331582,588039664,506748544,81291120,270707157,236041387
Kanha,Kanha,Kanha-Kanha,BEN_CI19,BEN_CI5,85560038,46065237,,39494801,46065237,,370653731,261143653,109510078,241812071,19331582,447217937,358814659,88403278,289122614,69692045
Kanha,Kanha,Kanha-Kanha,BEN_CI19,BEN_CI6,109331808,57488146,1006791,51843662,56481355,1006791,370653731,261143653,109510078,241812071,19331582,558093435,456569955,101523480,304633087,151936868
Kanha,Kanha,Kanha-Kanha,BEN_CI19,BEN_CI7,117128433,77333114,2233963,39795319,75099151,2233963,370653731,261143653,109510078,241812071,19331582,746271387,730520258,15751129,197580294,532939964
Kanha,Kanha,Kanha-Kanha,BEN_CI3,BEN_CI15,183121213,124088051,25344479,59033162,98743572,10356189,399948004,398407865,1540139,114426239,283981626,558426844,440368350,118058494,313676252,126692098
Kanha,Kanha,Kanha-Kanha,BEN_CI3,BEN_CI16,269045648,201835007,59856202,67210641,141978805,23806838,399948004,398407865,1540139,114426239,283981626,941465693,865515372,75950321,260165870,605349502
Kanha,Kanha,Kanha-Kanha,BEN_CI3,BEN_CI18,162024513,105405417,18277106,56619096,87128311,7491106,399948004,398407865,1540139,114426239,283981626,531335982,416398696,114937286,280261230,136137466
Kanha,Kanha,Kanha-Kanha,BEN_CI3,BEN_CI19,117152356,64146661,1259335,53005695,62887326,1259335,399948004,398407865,1540139,114426239,283981626,370653731,261143653,109510078,241812071,19331582
Kanha,Kanha,Kanha-Kanha,BEN_CI3,BEN_CI4,169684061,118275172,13992476,51408889,104282696,4240881,399948004,398407865,1540139,114426239,283981626,588039664,506748544,81291120,270707157,236041387
Kanha,Kanha,Kanha-Kanha,BEN_CI3,BEN_CI5,139192869,93450955,6552242,45741914,86898713,2636253,399948004,398407865,1540139,114426239,283981626,447217937,358814659,88403278,289122614,69692045
Kanha,Kanha,Kanha-Kanha,BEN_CI3,BEN_CI6,162641612,109384634,10545625,53256978,98839009,5277504,399948004,398407865,1540139,114426239,283981626,558093435,456569955,101523480,304633087,151936868
Kanha,Kanha,Kanha-Kanha,BEN_CI3,BEN_CI7,228243195,189285497,70977398,38957698,118308099,24135105,399948004,398407865,1540139,114426239,283981626,746271387,730520258,15751129,197580294,532939964
Kanha,Kanha,Kanha-Kanha,BEN_CI4,BEN_CI15,192590644,141251026,24171410,51339618,117079616,12256767,588039664,506748544,81291120,270707157,236041387,558426844,440368350,118058494,313676252,126692098
Kanha,Kanha,Kanha-Kanha,BEN_CI4,BEN_CI16,272110246,218173785,74728696,53936461,143445089,29053522,588039664,506748544,81291120,270707157,236041387,941465693,865515372,75950321,260165870,605349502
Kanha,Kanha,Kanha-Kanha,BEN_CI4,BEN_CI18,252619174,195180939,64501942,57438235,130678997,25431595,588039664,506748544,81291120,270707157,236041387,531335982,416398696,114937286,280261230,136137466
Kanha,Kanha,Kanha-Kanha,BEN_CI4,BEN_CI19,115695637,65049551,1689665,50646086,63359886,1689665,588039664,506748544,81291120,270707157,236041387,370653731,261143653,109510078,241812071,19331582
Kanha,Kanha,Kanha-Kanha,BEN_CI4,BEN_CI3,169684061,118275172,13992476,51408889,104282696,4240881,588039664,506748544,81291120,270707157,236041387,399948004,398407865,1540139,114426239,283981626
Kanha,Kanha,Kanha-Kanha,BEN_CI4,BEN_CI5,135749450,97129779,13979255,38619671,83150524,13979255,588039664,506748544,81291120,270707157,236041387,447217937,358814659,88403278,289122614,69692045
Kanha,Kanha,Kanha-Kanha,BEN_CI4,BEN_CI6,190549388,140999634,15140603,49549754,125859031,15140603,588039664,506748544,81291120,270707157,236041387,558093435,456569955,101523480,304633087,151936868
Kanha,Kanha,Kanha-Kanha,BEN_CI4,BEN_CI7,206364817,177410875,48441284,28953942,128969591,19124295,588039664,506748544,81291120,270707157,236041387,746271387,730520258,15751129,197580294,532939964
Kanha,Kanha,Kanha-Kanha,BEN_CI5,BEN_CI15,132571592,87177891,,45393701,87177891,,447217937,358814659,88403278,289122614,69692045,558426844,440368350,118058494,313676252,126692098
Kanha,Kanha,Kanha-Kanha,BEN_CI5,BEN_CI16,198726799,146126025,13178661,52600774,132947364,10693363,447217937,358814659,88403278,289122614,69692045,941465693,865515372,75950321,260165870,605349502
Kanha,Kanha,Kanha-Kanha,BEN_CI5,BEN_CI18,114137811,69746303,1113803,44391508,68632500,1113803,447217937,358814659,88403278,289122614,69692045,531335982,416398696,114937286,280261230,136137466
Kanha,Kanha,Kanha-Kanha,BEN_CI5,BEN_CI19,85560038,46065237,,39494801,46065237,,447217937,358814659,88403278,289122614,69692045,370653731,261143653,109510078,241812071,19331582
Kanha,Kanha,Kanha-Kanha,BEN_CI5,BEN_CI3,139192869,93450955,6552242,45741914,86898713,2636253,447217937,358814659,88403278,289122614,69692045,399948004,398407865,1540139,114426239,283981626
Kanha,Kanha,Kanha-Kanha,BEN_CI5,BEN_CI4,135749450,97129779,13979255,38619671,83150524,13979255,447217937,358814659,88403278,289122614,69692045,588039664,506748544,81291120,270707157,236041387
Kanha,Kanha,Kanha-Kanha,BEN_CI5,BEN_CI6,125043369,81579651,,43463718,81579651,,447217937,358814659,88403278,289122614,69692045,558093435,456569955,101523480,304633087,151936868
Kanha,Kanha,Kanha-Kanha,BEN_CI5,BEN_CI7,161561603,131914823,16096174,29646780,115818649,8655441,447217937,358814659,88403278,289122614,69692045,746271387,730520258,15751129,197580294,532939964
Kanha,Kanha,Kanha-Kanha,BEN_CI6,BEN_CI15,217337252,157600926,31984510,59736326,125616416,14671086,558093435,456569955,101523480,304633087,151936868,558426844,440368350,118058494,313676252,126692098
Kanha,Kanha,Kanha-Kanha,BEN_CI6,BEN_CI16,242600243,180351690,44349425,62248553,136002265,22070368,558093435,456569955,101523480,304633087,151936868,941465693,865515372,75950321,260165870,605349502
Kanha,Kanha,Kanha-Kanha,BEN_CI6,BEN_CI18,166645078,111158737,5503268,55486341,105655469,5503268,558093435,456569955,101523480,304633087,151936868,531335982,416398696,114937286,280261230,136137466
Kanha,Kanha,Kanha-Kanha,BEN_CI6,BEN_CI19,109331808,57488146,1006791,51843662,56481355,1006791,558093435,456569955,101523480,304633087,151936868,370653731,261143653,109510078,241812071,19331582
Kanha,Kanha,Kanha-Kanha,BEN_CI6,BEN_CI3,162641612,109384634,10545625,53256978,98839009,5277504,558093435,456569955,101523480,304633087,151936868,399948004,398407865,1540139,114426239,283981626
Kanha,Kanha,Kanha-Kanha,BEN_CI6,BEN_CI4,190549388,140999634,15140603,49549754,125859031,15140603,558093435,456569955,101523480,304633087,151936868,588039664,506748544,81291120,270707157,236041387
Kanha,Kanha,Kanha-Kanha,BEN_CI6,BEN_CI5,125043369,81579651,,43463718,81579651,,558093435,456569955,101523480,304633087,151936868,447217937,358814659,88403278,289122614,69692045
Kanha,Kanha,Kanha-Kanha,BEN_CI6,BEN_CI7,186246942,149188876,27047444,37058066,122141432,17345132,558093435,456569955,101523480,304633087,151936868,746271387,730520258,15751129,197580294,532939964
Kanha,Kanha,Kanha-Kanha,BEN_CI7,BEN_CI15,193589896,154323499,32647683,39266397,121675816,14142121,746271387,730520258,15751129,197580294,532939964,558426844,440368350,118058494,313676252,126692098
Kanha,Kanha,Kanha-Kanha,BEN_CI7,BEN_CI16,367511716,339427017,193637967,28084699,145789050,53651675,746271387,730520258,15751129,197580294,532939964,941465693,865515372,75950321,260165870,605349502
Kanha,Kanha,Kanha-Kanha,BEN_CI7,BEN_CI18,179854971,139638325,25610835,40216646,114027490,18345877,746271387,730520258,15751129,197580294,532939964,531335982,416398696,114937286,280261230,136137466
Kanha,Kanha,Kanha-Kanha,BEN_CI7,BEN_CI19,117128433,77333114,2233963,39795319,75099151,2233963,746271387,730520258,15751129,197580294,532939964,370653731,261143653,109510078,241812071,19331582
Kanha,Kanha,Kanha-Kanha,BEN_CI7,BEN_CI3,228243195,189285497,70977398,38957698,118308099,24135105,746271387,730520258,15751129,197580294,532939964,399948004,398407865,1540139,114426239,283981626
Kanha,Kanha,Kanha-Kanha,BEN_CI7,BEN_CI4,206364817,177410875,48441284,28953942,128969591,19124295,746271387,730520258,15751129,197580294,532939964,588039664,506748544,81291120,270707157,236041387
Kanha,Kanha,Kanha-Kanha,BEN_CI7,BEN_CI5,161561603,131914823,16096174,29646780,115818649,8655441,746271387,730520258,15751129,197580294,532939964,447217937,358814659,88403278,289122614,69692045
Kanha,Kanha,Kanha-Kanha,BEN_CI7,BEN_CI6,186246942,149188876,27047444,37058066,122141432,17345132,746271387,730520258,15751129,197580294,532939964,558093435,456569955,101523480,304633087,151936868
Kanha,Kaziranga,Kanha-Kaziranga,BEN_CI15,BEN_NE1,143613150,85959879,10216495,57653271,75743384,1340911,558426844,440368350,118058494,313676252,126692098,560246780,423100976,137145804,256700947,166400029
Kanha,Kaziranga,Kanha-Kaziranga,BEN_CI15,BEN_NE2,324079469,242168209,57569017,81911260,184599192,36822532,558426844,440368350,118058494,313676252,126692098,1250511108,1174630426,75880682,233913209,940717217
Kanha,Kaziranga,Kanha-Kaziranga,BEN_CI15,BEN_NE3,268833225,198248033,41450450,70585192,156797583,23189721,558426844,440368350,118058494,313676252,126692098,1008859852,937520336,71339516,277485474,660034862
Kanha,Kaziranga,Kanha-Kaziranga,BEN_CI16,BEN_NE1,236956712,164960515,47863412,71996197,117097103,25201606,941465693,865515372,75950321,260165870,605349502,560246780,423100976,137145804,256700947,166400029
Kanha,Kaziranga,Kanha-Kaziranga,BEN_CI16,BEN_NE2,554014011,481164593,290568292,72849418,190596301,73944566,941465693,865515372,75950321,260165870,605349502,1250511108,1174630426,75880682,233913209,940717217
Kanha,Kaziranga,Kanha-Kaziranga,BEN_CI16,BEN_NE3,429063470,365173423,175555852,63890047,189617571,53858923,941465693,865515372,75950321,260165870,605349502,1008859852,937520336,71339516,277485474,660034862
Kanha,Kaziranga,Kanha-Kaziranga,BEN_CI18,BEN_NE1,135645696,76804618,2469067,58841078,74335551,2469067,531335982,416398696,114937286,280261230,136137466,560246780,423100976,137145804,256700947,166400029
Kanha,Kaziranga,Kanha-Kaziranga,BEN_CI18,BEN_NE2,284651696,201924978,28171934,82726718,173753044,17617892,531335982,416398696,114937286,280261230,136137466,1250511108,1174630426,75880682,233913209,940717217
Kanha,Kaziranga,Kanha-Kaziranga,BEN_CI18,BEN_NE3,248305854,177200210,39039015,71105644,138161195,26182315,531335982,416398696,114937286,280261230,136137466,1008859852,937520336,71339516,277485474,660034862
Kanha,Kaziranga,Kanha-Kaziranga,BEN_CI19,BEN_NE1,99504979,50347861,2492073,49157118,47855788,2492073,370653731,261143653,109510078,241812071,19331582,560246780,423100976,137145804,256700947,166400029
Kanha,Kaziranga,Kanha-Kaziranga,BEN_CI19,BEN_NE2,212815865,140227510,12028286,72588355,128199224,12028286,370653731,261143653,109510078,241812071,19331582,1250511108,1174630426,75880682,233913209,940717217
Kanha,Kaziranga,Kanha-Kaziranga,BEN_CI19,BEN_NE3,165154006,101930153,3635721,63223853,98294432,3635721,370653731,261143653,109510078,241812071,19331582,1008859852,937520336,71339516,277485474,660034862
Kanha,Kaziranga,Kanha-Kaziranga,BEN_CI3,BEN_NE1,149797287,89940985,15956927,59856302,73984058,9379426,399948004,398407865,1540139,114426239,283981626,560246780,423100976,137145804,256700947,166400029
Kanha,Kaziranga,Kanha-Kaziranga,BEN_CI3,BEN_NE2,346836050,262766534,84692352,84069516,178074182,27445318,399948004,398407865,1540139,114426239,283981626,1250511108,1174630426,75880682,233913209,940717217
Kanha,Kaziranga,Kanha-Kaziranga,BEN_CI3,BEN_NE3,279874934,206727886,71727834,73147048,135000052,26490234,399948004,398407865,1540139,114426239,283981626,1008859852,937520336,71339516,277485474,660034862
Kanha,Kaziranga,Kanha-Kaziranga,BEN_CI4,BEN_NE1,149042368,94384247,12347037,54658121,82037210,4591478,588039664,506748544,81291120,270707157,236041387,560246780,423100976,137145804,256700947,166400029
Kanha,Kaziranga,Kanha-Kaziranga,BEN_CI4,BEN_NE2,335468856,269661789,96999887,65807067,172661902,34842750,588039664,506748544,81291120,270707157,236041387,1250511108,1174630426,75880682,233913209,940717217
Kanha,Kaziranga,Kanha-Kaziranga,BEN_CI4,BEN_NE3,258639180,197650712,44259880,60988468,153390832,27829827,588039664,506748544,81291120,270707157,236041387,1008859852,937520336,71339516,277485474,660034862
Kanha,Kaziranga,Kanha-Kaziranga,BEN_CI5,BEN_NE1,117356061,70732105,5375743,46623956,65356362,5375743,447217937,358814659,88403278,289122614,69692045,560246780,423100976,137145804,256700947,166400029
Kanha,Kaziranga,Kanha-Kaziranga,BEN_CI5,BEN_NE2,263608465,203454823,37790989,60153642,165663834,25282326,447217937,358814659,88403278,289122614,69692045,1250511108,1174630426,75880682,233913209,940717217
Kanha,Kaziranga,Kanha-Kaziranga,BEN_CI5,BEN_NE3,187706072,129153300,15559697,58552772,113593603,11179980,447217937,358814659,88403278,289122614,69692045,1008859852,937520336,71339516,277485474,660034862
Kanha,Kaziranga,Kanha-Kaziranga,BEN_CI6,BEN_NE1,137930165,80879165,4738110,57051000,76141055,4738110,558093435,456569955,101523480,304633087,151936868,560246780,423100976,137145804,256700947,166400029
Kanha,Kaziranga,Kanha-Kaziranga,BEN_CI6,BEN_NE2,324201515,250124014,70700839,74077501,179423175,34513420,558093435,456569955,101523480,304633087,151936868,1250511108,1174630426,75880682,233913209,940717217
Kanha,Kaziranga,Kanha-Kaziranga,BEN_CI6,BEN_NE3,267483966,202701873,56254302,64782093,146447571,36713775,558093435,456569955,101523480,304633087,151936868,1008859852,937520336,71339516,277485474,660034862
Kanha,Kaziranga,Kanha-Kaziranga,BEN_CI7,BEN_NE1,190565854,143409553,44222826,47156301,99186727,23489847,746271387,730520258,15751129,197580294,532939964,560246780,423100976,137145804,256700947,166400029
Kanha,Kaziranga,Kanha-Kaziranga,BEN_CI7,BEN_NE2,403841621,368620074,197933628,35221547,170686446,59240430,746271387,730520258,15751129,197580294,532939964,1250511108,1174630426,75880682,233913209,940717217
Kanha,Kaziranga,Kanha-Kaziranga,BEN_CI7,BEN_NE3,320349383,287090262,126080569,33259121,161009693,44616669,746271387,730520258,15751129,197580294,532939964,1008859852,937520336,71339516,277485474,660034862
Kanha,Lalgarh,Kanha-Lalgarh,BEN_CI15,LGS1,186039447,117481542,8452956,68557905,109028586,6336653,558426844,440368350,118058494,313676252,126692098,737843728,638009894,99833834,404772144,233237750
Kanha,Lalgarh,Kanha-Lalgarh,BEN_CI16,LGS1,301581306,235143170,61825480,66438136,173317690,43323236,941465693,865515372,75950321,260165870,605349502,737843728,638009894,99833834,404772144,233237750
Kanha,Lalgarh,Kanha-Lalgarh,BEN_CI18,LGS1,176174703,108283728,10349244,67890975,97934484,10349244,531335982,416398696,114937286,280261230,136137466,737843728,638009894,99833834,404772144,233237750
Kanha,Lalgarh,Kanha-Lalgarh,BEN_CI19,LGS1,123241582,67120116,,56121466,67120116,,370653731,261143653,109510078,241812071,19331582,737843728,638009894,99833834,404772144,233237750
Kanha,Lalgarh,Kanha-Lalgarh,BEN_CI3,LGS1,192523125,122351697,6880669,70171428,115471028,6880669,399948004,398407865,1540139,114426239,283981626,737843728,638009894,99833834,404772144,233237750
Kanha,Lalgarh,Kanha-Lalgarh,BEN_CI4,LGS1,195009763,138420694,21366495,56589069,117054199,11739414,588039664,506748544,81291120,270707157,236041387,737843728,638009894,99833834,404772144,233237750
Kanha,Lalgarh,Kanha-Lalgarh,BEN_CI5,LGS1,164510269,112055259,5267388,52455010,106787871,2476514,447217937,358814659,88403278,289122614,69692045,737843728,638009894,99833834,404772144,233237750
Kanha,Lalgarh,Kanha-Lalgarh,BEN_CI6,LGS1,196802490,133328908,23781976,63473582,109546932,15837706,558093435,456569955,101523480,304633087,151936868,737843728,638009894,99833834,404772144,233237750
Kanha,Lalgarh,Kanha-Lalgarh,BEN_CI7,LGS1,213516752,175417757,28280246,38098995,147137511,17375521,746271387,730520258,15751129,197580294,532939964,737843728,638009894,99833834,404772144,233237750
Kanha,Periyar,Kanha-Periyar,BEN_CI15,BEN_SI5,329271930,244047391,37635841,85224539,206411550,24664304,558426844,440368350,118058494,313676252,126692098,1343835283,1299687777,44147506,344660143,955027634
Kanha,Periyar,Kanha-Periyar,BEN_CI16,BEN_SI5,576666138,516883689,274318842,59782449,242564847,109045522,941465693,865515372,75950321,260165870,605349502,1343835283,1299687777,44147506,344660143,955027634
Kanha,Periyar,Kanha-Periyar,BEN_CI18,BEN_SI5,331357269,250023679,56992428,81333590,193031251,30357260,531335982,416398696,114937286,280261230,136137466,1343835283,1299687777,44147506,344660143,955027634
Kanha,Periyar,Kanha-Periyar,BEN_CI19,BEN_SI5,236431413,159809292,10623095,76622121,149186197,10623095,370653731,261143653,109510078,241812071,19331582,1343835283,1299687777,44147506,344660143,955027634
Kanha,Periyar,Kanha-Periyar,BEN_CI3,BEN_SI5,372673265,293898628,79067468,78774637,214831160,40859063,399948004,398407865,1540139,114426239,283981626,1343835283,1299687777,44147506,344660143,955027634
Kanha,Periyar,Kanha-Periyar,BEN_CI4,BEN_SI5,361569242,298844317,98195163,62724925,200649154,44822067,588039664,506748544,81291120,270707157,236041387,1343835283,1299687777,44147506,344660143,955027634
Kanha,Periyar,Kanha-Periyar,BEN_CI5,BEN_SI5,273854934,213145561,27379800,60709373,185765761,18160895,447217937,358814659,88403278,289122614,69692045,1343835283,1299687777,44147506,344660143,955027634
Kanha,Periyar,Kanha-Periyar,BEN_CI6,BEN_SI5,334885819,264369160,56427066,70516659,207942094,26061074,558093435,456569955,101523480,304633087,151936868,1343835283,1299687777,44147506,344660143,955027634
Kanha,Periyar,Kanha-Periyar,BEN_CI7,BEN_SI5,463012232,440579128,227879259,22433104,212699869,96016814,746271387,730520258,15751129,197580294,532939964,1343835283,1299687777,44147506,344660143,955027634
Kanha,Ranthambore,Kanha-Ranthambore,BEN_CI15,BEN_NW10,324712376,245908001,59950287,78804375,185957714,30546207,558426844,440368350,118058494,313676252,126692098,1266198710,1229664069,36534641,328923565,900740504
Kanha,Ranthambore,Kanha-Ranthambore,BEN_CI15,BEN_NW11,249622748,186976515,41494542,62646233,145481973,20640253,558426844,440368350,118058494,313676252,126692098,997123987,950413379,46710608,263905963,686507416
Kanha,Ranthambore,Kanha-Ranthambore,BEN_CI15,BEN_NW12,318112468,242423055,55560912,75689413,186862143,24899206,558426844,440368350,118058494,313676252,126692098,1267506856,1231795407,35711449,227052846,1004742561
Kanha,Ranthambore,Kanha-Ranthambore,BEN_CI15,BEN_NW13,297751146,224393591,57702933,73357555,166690658,33447643,558426844,440368350,118058494,313676252,126692098,1183131254,1138285233,44846021,344174628,794110605
Kanha,Ranthambore,Kanha-Ranthambore,BEN_CI15,BEN_NW14,308698709,234863570,64265624,73835139,170597946,26315449,558426844,440368350,118058494,313676252,126692098,1235716540,1190952996,44763544,177541519,1013411477
Kanha,Ranthambore,Kanha-Ranthambore,BEN_CI15,BEN_NW17,273085979,202833690,43178895,70252289,159654795,19710140,558426844,440368350,118058494,313676252,126692098,1116321554,1085802823,30518731,256140006,829662817
Kanha,Ranthambore,Kanha-Ranthambore,BEN_CI15,BEN_NW18,343028683,264094396,73796135,78934287,190298261,28757710,558426844,440368350,118058494,313676252,126692098,1339364699,1300736006,38628693,242877521,1057858485
Kanha,Ranthambore,Kanha-Ranthambore,BEN_CI15,BEN_NW19,267483459,197567354,34915985,69916105,162651369,14697859,558426844,440368350,118058494,313676252,126692098,1081768306,1036331080,45437226,232322355,804008725
Kanha,Ranthambore,Kanha-Ranthambore,BEN_CI15,BEN_NW20,268050090,190776281,23258929,77273809,167517352,23258929,558426844,440368350,118058494,313676252,126692098,1086271749,1022278981,63992768,541693814,480585167
Kanha,Ranthambore,Kanha-Ranthambore,BEN_CI15,BEN_NW24,284493119,208201276,36628087,76291843,171573189,25815572,558426844,440368350,118058494,313676252,126692098,1159641386,1113494396,46146990,301627698,811866698
Kanha,Ranthambore,Kanha-Ranthambore,BEN_CI15,BEN_NW3,299485694,223542193,33529317,75943501,190012876,22108745,558426844,440368350,118058494,313676252,126692098,1280728709,1240123254,40605455,207797688,1032325566
Kanha,Ranthambore,Kanha-Ranthambore,BEN_CI15,BEN_NW4,318929549,249390020,71964642,69539529,177425378,33207209,558426844,440368350,118058494,313676252,126692098,1219365724,1186222475,33143249,158691252,1027531223
Kanha,Ranthambore,Kanha-Ranthambore,BEN_CI15,BEN_NW5,253592164,186364315,43758209,67227849,142606106,20167903,558426844,440368350,118058494,313676252,126692098,977809134,918585062,59224072,241966240,676618822
Kanha,Ranthambore,Kanha-Ranthambore,BEN_CI15,BEN_NW55,283806229,205785211,29740856,78021018,176044355,27097228,558426844,440368350,118058494,313676252,126692098,1131174741,1073214798,57959943,534097691,539117107
Kanha,Ranthambore,Kanha-Ranthambore,BEN_CI15,BEN_NW57,295750116,207241655,19801912,88508461,187439743,17302457,558426844,440368350,118058494,313676252,126692098,1180288036,1103120235,77167801,638361097,464759138
Kanha,Ranthambore,Kanha-Ranthambore,BEN_CI15,BEN_NW6,244383603,179976621,42183268,64406982,137793353,25090614,558426844,440368350,118058494,313676252,126692098,992143483,946435718,45707765,248527765,697907953
Kanha,Ranthambore,Kanha-Ranthambore,BEN_CI15,BEN_NW8,309816228,235772704,56838171,74043524,178934533,32451814,558426844,440368350,118058494,313676252,126692098,1196839698,1156984240,39855458,275076038,881908202
Kanha,Ranthambore,Kanha-Ranthambore,BEN_CI15,BEN_NW9,317904197,244605861,60217593,73298336,184388268,36886307,558426844,440368350,118058494,313676252,126692098,1246521228,1203200533,43320695,216389572,986810961
Kanha,Ranthambore,Kanha-Ranthambore,BEN_CI16,BEN_NW10,544061053,485058909,261806463,59002144,223252446,109703410,941465693,865515372,75950321,260165870,605349502,1266198710,1229664069,36534641,328923565,900740504
Kanha,Ranthambore,Kanha-Ranthambore,BEN_CI16,BEN_NW11,394812162,340378328,151905811,54433834,188472517,62959676,941465693,865515372,75950321,260165870,605349502,997123987,950413379,46710608,263905963,686507416
Kanha,Ranthambore,Kanha-Ranthambore,BEN_CI16,BEN_NW12,545783579,491520728,288507380,54262851,203013348,97939512,941465693,865515372,75950321,260165870,605349502,1267506856,1231795407,35711449,227052846,1004742561
Kanha,Ranthambore,Kanha-Ranthambore,BEN_CI16,BEN_NW13,480227617,420941374,183573228,59286243,237368146,104083876,941465693,865515372,75950321,260165870,605349502,1183131254,1138285233,44846021,344174628,794110605
Kanha,Ranthambore,Kanha-Ranthambore,BEN_CI16,BEN_NW14,524396838,467068878,275504170,57327960,191564708,81023970,941465693,865515372,75950321,260165870,605349502,1235716540,1190952996,44763544,177541519,1013411477
Kanha,Ranthambore,Kanha-Ranthambore,BEN_CI16,BEN_NW17,437406866,382730226,192948576,54676640,189781650,77846984,941465693,865515372,75950321,260165870,605349502,1116321554,1085802823,30518731,256140006,829662817
Kanha,Ranthambore,Kanha-Ranthambore,BEN_CI16,BEN_NW18,543969239,483430743,264883342,60538496,218547401,71442771,941465693,865515372,75950321,260165870,605349502,1339364699,1300736006,38628693,242877521,1057858485
Kanha,Ranthambore,Kanha-Ranthambore,BEN_CI16,BEN_NW19,437045060,378471179,191396910,58573881,187074269,58813098,941465693,865515372,75950321,260165870,605349502,1081768306,1036331080,45437226,232322355,804008725
Kanha,Ranthambore,Kanha-Ranthambore,BEN_CI16,BEN_NW20,465659939,401312640,146319004,64347299,254993636,96409943,941465693,865515372,75950321,260165870,605349502,1086271749,1022278981,63992768,541693814,480585167
Kanha,Ranthambore,Kanha-Ranthambore,BEN_CI16,BEN_NW24,461867248,399659407,177699141,62207841,221960266,75173690,941465693,865515372,75950321,260165870,605349502,1159641386,1113494396,46146990,301627698,811866698
Kanha,Ranthambore,Kanha-Ranthambore,BEN_CI16,BEN_NW3,511117742,450240910,242970318,60876832,207270592,59764160,941465693,865515372,75950321,260165870,605349502,1280728709,1240123254,40605455,207797688,1032325566
Kanha,Ranthambore,Kanha-Ranthambore,BEN_CI16,BEN_NW4,503808011,451063768,256677035,52744243,194386733,82811409,941465693,865515372,75950321,260165870,605349502,1219365724,1186222475,33143249,158691252,1027531223
Kanha,Ranthambore,Kanha-Ranthambore,BEN_CI16,BEN_NW5,393198671,336651156,157911909,56547515,178739247,62271086,941465693,865515372,75950321,260165870,605349502,977809134,918585062,59224072,241966240,676618822
Kanha,Ranthambore,Kanha-Ranthambore,BEN_CI16,BEN_NW55,477020002,412267129,151733733,64752873,260533396,98111639,941465693,865515372,75950321,260165870,605349502,1131174741,1073214798,57959943,534097691,539117107
Kanha,Ranthambore,Kanha-Ranthambore,BEN_CI16,BEN_NW57,473374923,396517101,117366237,76857822,279150864,75182042,941465693,865515372,75950321,260165870,605349502,1180288036,1103120235,77167801,638361097,464759138
Kanha,Ranthambore,Kanha-Ranthambore,BEN_CI16,BEN_NW6,413616671,361979725,182528546,51636946,179451179,59232063,941465693,865515372,75950321,260165870,605349502,992143483,946435718,45707765,248527765,697907953
Kanha,Ranthambore,Kanha-Ranthambore,BEN_CI16,BEN_NW8,494052158,435904311,207538738,58147847,228365573,98341114,941465693,865515372,75950321,260165870,605349502,1196839698,1156984240,39855458,275076038,881908202
Kanha,Ranthambore,Kanha-Ranthambore,BEN_CI16,BEN_NW9,534287143,475357326,279024157,58929817,196333169,73797435,941465693,865515372,75950321,260165870,605349502,1246521228,1203200533,43320695,216389572,986810961
Kanha,Ranthambore,Kanha-Ranthambore,BEN_CI18,BEN_NW10,300862620,223144930,49376807,77717690,173768123,34070700,531335982,416398696,114937286,280261230,136137466,1266198710,1229664069,36534641,328923565,900740504
Kanha,Ranthambore,Kanha-Ranthambore,BEN_CI18,BEN_NW11,233654266,172033038,37098604,61621228,134934434,18770341,531335982,416398696,114937286,280261230,136137466,997123987,950413379,46710608,263905963,686507416
Kanha,Ranthambore,Kanha-Ranthambore,BEN_CI18,BEN_NW12,294752960,220920567,49483170,73832393,171437397,39578573,531335982,416398696,114937286,280261230,136137466,1267506856,1231795407,35711449,227052846,1004742561
Kanha,Ranthambore,Kanha-Ranthambore,BEN_CI18,BEN_NW13,270350596,194447922,41747852,75902674,152700070,24891310,531335982,416398696,114937286,280261230,136137466,1183131254,1138285233,44846021,344174628,794110605
Kanha,Ranthambore,Kanha-Ranthambore,BEN_CI18,BEN_NW14,293753590,220586635,53478630,73166955,167108005,28969342,531335982,416398696,114937286,280261230,136137466,1235716540,1190952996,44763544,177541519,1013411477
Kanha,Ranthambore,Kanha-Ranthambore,BEN_CI18,BEN_NW17,255430276,185816940,43489564,69613336,142327376,18131005,531335982,416398696,114937286,280261230,136137466,1116321554,1085802823,30518731,256140006,829662817
Kanha,Ranthambore,Kanha-Ranthambore,BEN_CI18,BEN_NW18,321897492,244896478,68527386,77001014,176369092,37707974,531335982,416398696,114937286,280261230,136137466,1339364699,1300736006,38628693,242877521,1057858485
Kanha,Ranthambore,Kanha-Ranthambore,BEN_CI18,BEN_NW19,263350770,194005833,49957357,69344937,144048476,22798028,531335982,416398696,114937286,280261230,136137466,1081768306,1036331080,45437226,232322355,804008725
Kanha,Ranthambore,Kanha-Ranthambore,BEN_CI18,BEN_NW20,256586411,177763531,14330704,78822880,163432827,10379012,531335982,416398696,114937286,280261230,136137466,1086271749,1022278981,63992768,541693814,480585167
Kanha,Ranthambore,Kanha-Ranthambore,BEN_CI18,BEN_NW24,273167665,201087328,36708838,72080337,164378490,27866065,531335982,416398696,114937286,280261230,136137466,1159641386,1113494396,46146990,301627698,811866698
Kanha,Ranthambore,Kanha-Ranthambore,BEN_CI18,BEN_NW3,317453126,245636128,81843427,71816998,163792701,36851545,531335982,416398696,114937286,280261230,136137466,1280728709,1240123254,40605455,207797688,1032325566
Kanha,Ranthambore,Kanha-Ranthambore,BEN_CI18,BEN_NW4,301645855,234579891,84828906,67065964,149750985,34984008,531335982,416398696,114937286,280261230,136137466,1219365724,1186222475,33143249,158691252,1027531223
Kanha,Ranthambore,Kanha-Ranthambore,BEN_CI18,BEN_NW5,235981233,173150654,44164402,62830579,128986252,25745786,531335982,416398696,114937286,280261230,136137466,977809134,918585062,59224072,241966240,676618822
Kanha,Ranthambore,Kanha-Ranthambore,BEN_CI18,BEN_NW55,262918829,188330000,22338922,74588829,165991078,19335231,531335982,416398696,114937286,280261230,136137466,1131174741,1073214798,57959943,534097691,539117107
Kanha,Ranthambore,Kanha-Ranthambore,BEN_CI18,BEN_NW57,281628142,194201281,17272649,87426861,176928632,13348774,531335982,416398696,114937286,280261230,136137466,1180288036,1103120235,77167801,638361097,464759138
Kanha,Ranthambore,Kanha-Ranthambore,BEN_CI18,BEN_NW6,233915018,170298615,32911858,63616403,137386757,15389045,531335982,416398696,114937286,280261230,136137466,992143483,946435718,45707765,248527765,697907953
Kanha,Ranthambore,Kanha-Ranthambore,BEN_CI18,BEN_NW8,297006677,224710871,62232734,72295806,162478137,41002801,531335982,416398696,114937286,280261230,136137466,1196839698,1156984240,39855458,275076038,881908202
Kanha,Ranthambore,Kanha-Ranthambore,BEN_CI18,BEN_NW9,291697006,215204022,62522297,76492984,152681725,33460604,531335982,416398696,114937286,280261230,136137466,1246521228,1203200533,43320695,216389572,986810961
Kanha,Ranthambore,Kanha-Ranthambore,BEN_CI19,BEN_NW10,214082160,142226529,8800485,71855631,133426044,8800485,370653731,261143653,109510078,241812071,19331582,1266198710,1229664069,36534641,328923565,900740504
Kanha,Ranthambore,Kanha-Ranthambore,BEN_CI19,BEN_NW11,162714188,104981680,6457992,57732508,98523688,6457992,370653731,261143653,109510078,241812071,19331582,997123987,950413379,46710608,263905963,686507416
Kanha,Ranthambore,Kanha-Ranthambore,BEN_CI19,BEN_NW12,203614189,134630572,5791192,68983617,128839380,5791192,370653731,261143653,109510078,241812071,19331582,1267506856,1231795407,35711449,227052846,1004742561
Kanha,Ranthambore,Kanha-Ranthambore,BEN_CI19,BEN_NW13,183347210,118676125,2377884,64671085,116298241,2377884,370653731,261143653,109510078,241812071,19331582,1183131254,1138285233,44846021,344174628,794110605
Kanha,Ranthambore,Kanha-Ranthambore,BEN_CI19,BEN_NW14,204061618,136040805,10717691,68020813,125323114,10717691,370653731,261143653,109510078,241812071,19331582,1235716540,1190952996,44763544,177541519,1013411477
Kanha,Ranthambore,Kanha-Ranthambore,BEN_CI19,BEN_NW17,188325592,122923960,8965938,65401632,113958022,8965938,370653731,261143653,109510078,241812071,19331582,1116321554,1085802823,30518731,256140006,829662817
Kanha,Ranthambore,Kanha-Ranthambore,BEN_CI19,BEN_NW18,216361275,143287704,6542271,73073571,136745433,6542271,370653731,261143653,109510078,241812071,19331582,1339364699,1300736006,38628693,242877521,1057858485
Kanha,Ranthambore,Kanha-Ranthambore,BEN_CI19,BEN_NW19,177776618,115748818,6032983,62027800,109715835,6032983,370653731,261143653,109510078,241812071,19331582,1081768306,1036331080,45437226,232322355,804008725
Kanha,Ranthambore,Kanha-Ranthambore,BEN_CI19,BEN_NW20,176917065,115388168,7115289,61528897,108272879,7115289,370653731,261143653,109510078,241812071,19331582,1086271749,1022278981,63992768,541693814,480585167
Kanha,Ranthambore,Kanha-Ranthambore,BEN_CI19,BEN_NW24,199098716,130994774,8727522,68103942,122267252,8727522,370653731,261143653,109510078,241812071,19331582,1159641386,1113494396,46146990,301627698,811866698
Kanha,Ranthambore,Kanha-Ranthambore,BEN_CI19,BEN_NW3,211940627,139498250,4948668,72442377,134549582,4948668,370653731,261143653,109510078,241812071,19331582,1280728709,1240123254,40605455,207797688,1032325566
Kanha,Ranthambore,Kanha-Ranthambore,BEN_CI19,BEN_NW4,208091436,141760646,9054937,66330790,132705709,9054937,370653731,261143653,109510078,241812071,19331582,1219365724,1186222475,33143249,158691252,1027531223
Kanha,Ranthambore,Kanha-Ranthambore,BEN_CI19,BEN_NW5,160513361,100152863,6398352,60360498,93754511,6398352,370653731,261143653,109510078,241812071,19331582,977809134,918585062,59224072,241966240,676618822
Kanha,Ranthambore,Kanha-Ranthambore,BEN_CI19,BEN_NW55,192719814,127539836,2477976,65179978,125061860,2477976,370653731,261143653,109510078,241812071,19331582,1131174741,1073214798,57959943,534097691,539117107
Kanha,Ranthambore,Kanha-Ranthambore,BEN_CI19,BEN_NW57,202523169,131148037,5876408,71375132,125271629,5876408,370653731,261143653,109510078,241812071,19331582,1180288036,1103120235,77167801,638361097,464759138
Kanha,Ranthambore,Kanha-Ranthambore,BEN_CI19,BEN_NW6,160604964,103291040,1355019,57313924,101936021,1355019,370653731,261143653,109510078,241812071,19331582,992143483,946435718,45707765,248527765,697907953
Kanha,Ranthambore,Kanha-Ranthambore,BEN_CI19,BEN_NW8,198419777,132834682,6206286,65585095,126628396,6206286,370653731,261143653,109510078,241812071,19331582,1196839698,1156984240,39855458,275076038,881908202
Kanha,Ranthambore,Kanha-Ranthambore,BEN_CI19,BEN_NW9,192985865,125965821,10599283,67020044,115366538,10599283,370653731,261143653,109510078,241812071,19331582,1246521228,1203200533,43320695,216389572,986810961
Kanha,Ranthambore,Kanha-Ranthambore,BEN_CI3,BEN_NW10,361127430,286509509,86276986,74617921,200232523,48975068,399948004,398407865,1540139,114426239,283981626,1266198710,1229664069,36534641,328923565,900740504
Kanha,Ranthambore,Kanha-Ranthambore,BEN_CI3,BEN_NW11,288654182,229561410,79433432,59092772,150127978,41908131,399948004,398407865,1540139,114426239,283981626,997123987,950413379,46710608,263905963,686507416
Kanha,Ranthambore,Kanha-Ranthambore,BEN_CI3,BEN_NW12,337025339,261918409,75260795,75106930,186657614,37864281,399948004,398407865,1540139,114426239,283981626,1267506856,1231795407,35711449,227052846,1004742561
Kanha,Ranthambore,Kanha-Ranthambore,BEN_CI3,BEN_NW13,309019001,238317008,67382400,70701993,170934608,38414740,399948004,398407865,1540139,114426239,283981626,1183131254,1138285233,44846021,344174628,794110605
Kanha,Ranthambore,Kanha-Ranthambore,BEN_CI3,BEN_NW14,361436241,292416531,129191220,69019710,163225311,49253417,399948004,398407865,1540139,114426239,283981626,1235716540,1190952996,44763544,177541519,1013411477
Kanha,Ranthambore,Kanha-Ranthambore,BEN_CI3,BEN_NW17,327275088,262896052,101959819,64379036,160936233,35178724,399948004,398407865,1540139,114426239,283981626,1116321554,1085802823,30518731,256140006,829662817
Kanha,Ranthambore,Kanha-Ranthambore,BEN_CI3,BEN_NW18,379331231,305817928,112197603,73513303,193620325,53706000,399948004,398407865,1540139,114426239,283981626,1339364699,1300736006,38628693,242877521,1057858485
Kanha,Ranthambore,Kanha-Ranthambore,BEN_CI3,BEN_NW19,308161778,238126457,91722161,70035321,146404296,29561949,399948004,398407865,1540139,114426239,283981626,1081768306,1036331080,45437226,232322355,804008725
Kanha,Ranthambore,Kanha-Ranthambore,BEN_CI3,BEN_NW20,300254042,222923831,44968512,77330211,177955319,30846961,399948004,398407865,1540139,114426239,283981626,1086271749,1022278981,63992768,541693814,480585167
Kanha,Ranthambore,Kanha-Ranthambore,BEN_CI3,BEN_NW24,320032094,247598275,76614080,72433819,170984195,34546711,399948004,398407865,1540139,114426239,283981626,1159641386,1113494396,46146990,301627698,811866698
Kanha,Ranthambore,Kanha-Ranthambore,BEN_CI3,BEN_NW3,357011863,282931531,101305971,74080332,181625560,38481243,399948004,398407865,1540139,114426239,283981626,1280728709,1240123254,40605455,207797688,1032325566
Kanha,Ranthambore,Kanha-Ranthambore,BEN_CI3,BEN_NW4,361021198,295459677,123001557,65561521,172458120,44524178,399948004,398407865,1540139,114426239,283981626,1219365724,1186222475,33143249,158691252,1027531223
Kanha,Ranthambore,Kanha-Ranthambore,BEN_CI3,BEN_NW5,274587260,212308196,74019577,62279064,138288619,35074122,399948004,398407865,1540139,114426239,283981626,977809134,918585062,59224072,241966240,676618822
Kanha,Ranthambore,Kanha-Ranthambore,BEN_CI3,BEN_NW55,313928239,239126792,50933422,74801447,188193370,33695872,399948004,398407865,1540139,114426239,283981626,1131174741,1073214798,57959943,534097691,539117107
Kanha,Ranthambore,Kanha-Ranthambore,BEN_CI3,BEN_NW57,322550304,234428253,34957499,88122051,199470754,29476449,399948004,398407865,1540139,114426239,283981626,1180288036,1103120235,77167801,638361097,464759138
Kanha,Ranthambore,Kanha-Ranthambore,BEN_CI3,BEN_NW6,287114547,226388727,90966575,60725820,135422152,34453691,399948004,398407865,1540139,114426239,283981626,992143483,946435718,45707765,248527765,697907953
Kanha,Ranthambore,Kanha-Ranthambore,BEN_CI3,BEN_NW8,323532270,252516314,79124499,71015956,173391815,36486319,399948004,398407865,1540139,114426239,283981626,1196839698,1156984240,39855458,275076038,881908202
Kanha,Ranthambore,Kanha-Ranthambore,BEN_CI3,BEN_NW9,365334155,291597928,123268597,73736227,168329331,38695861,399948004,398407865,1540139,114426239,283981626,1246521228,1203200533,43320695,216389572,986810961
Kanha,Ranthambore,Kanha-Ranthambore,BEN_CI4,BEN_NW10,351277051,293493405,119112212,57783646,174381193,62950241,588039664,506748544,81291120,270707157,236041387,1266198710,1229664069,36534641,328923565,900740504
Kanha,Ranthambore,Kanha-Ranthambore,BEN_CI4,BEN_NW11,280966127,234430492,91338495,46535635,143091997,36236010,588039664,506748544,81291120,270707157,236041387,997123987,950413379,46710608,263905963,686507416
Kanha,Ranthambore,Kanha-Ranthambore,BEN_CI4,BEN_NW12,336109177,283190380,113629422,52918797,169560958,43479631,588039664,506748544,81291120,270707157,236041387,1267506856,1231795407,35711449,227052846,1004742561
Kanha,Ranthambore,Kanha-Ranthambore,BEN_CI4,BEN_NW13,322388163,269053294,100246514,53334869,168806780,50619797,588039664,506748544,81291120,270707157,236041387,1183131254,1138285233,44846021,344174628,794110605
Kanha,Ranthambore,Kanha-Ranthambore,BEN_CI4,BEN_NW14,319143796,266977882,106349314,52165914,160628568,39697338,588039664,506748544,81291120,270707157,236041387,1235716540,1190952996,44763544,177541519,1013411477
Kanha,Ranthambore,Kanha-Ranthambore,BEN_CI4,BEN_NW17,293274937,241103084,80832311,52171853,160270773,31434256,588039664,506748544,81291120,270707157,236041387,1116321554,1085802823,30518731,256140006,829662817
Kanha,Ranthambore,Kanha-Ranthambore,BEN_CI4,BEN_NW18,339330938,282291756,89671476,57039182,192620280,31699166,588039664,506748544,81291120,270707157,236041387,1339364699,1300736006,38628693,242877521,1057858485
Kanha,Ranthambore,Kanha-Ranthambore,BEN_CI4,BEN_NW19,289833137,237807221,86512272,52025916,151294949,34867405,588039664,506748544,81291120,270707157,236041387,1081768306,1036331080,45437226,232322355,804008725
Kanha,Ranthambore,Kanha-Ranthambore,BEN_CI4,BEN_NW20,294433928,234543659,46323878,59890269,188219781,30261649,588039664,506748544,81291120,270707157,236041387,1086271749,1022278981,63992768,541693814,480585167
Kanha,Ranthambore,Kanha-Ranthambore,BEN_CI4,BEN_NW24,315809994,261496631,94619649,54313363,166876982,38240633,588039664,506748544,81291120,270707157,236041387,1159641386,1113494396,46146990,301627698,811866698
Kanha,Ranthambore,Kanha-Ranthambore,BEN_CI4,BEN_NW3,339235778,282655466,110137272,56580312,172518194,42141452,588039664,506748544,81291120,270707157,236041387,1280728709,1240123254,40605455,207797688,1032325566
Kanha,Ranthambore,Kanha-Ranthambore,BEN_CI4,BEN_NW4,326552518,275546680,110197805,51005838,165348875,34335063,588039664,506748544,81291120,270707157,236041387,1219365724,1186222475,33143249,158691252,1027531223
Kanha,Ranthambore,Kanha-Ranthambore,BEN_CI4,BEN_NW5,255236094,202446548,66127268,52789546,136319280,23670516,588039664,506748544,81291120,270707157,236041387,977809134,918585062,59224072,241966240,676618822
Kanha,Ranthambore,Kanha-Ranthambore,BEN_CI4,BEN_NW55,282501816,224522347,40664251,57979469,183858096,23904366,588039664,506748544,81291120,270707157,236041387,1131174741,1073214798,57959943,534097691,539117107
Kanha,Ranthambore,Kanha-Ranthambore,BEN_CI4,BEN_NW57,302243609,231860971,34714839,70382638,197146132,32407984,588039664,506748544,81291120,270707157,236041387,1180288036,1103120235,77167801,638361097,464759138
Kanha,Ranthambore,Kanha-Ranthambore,BEN_CI4,BEN_NW6,257948578,211409968,58250803,46538610,153159165,21727958,588039664,506748544,81291120,270707157,236041387,992143483,946435718,45707765,248527765,697907953
Kanha,Ranthambore,Kanha-Ranthambore,BEN_CI4,BEN_NW8,292362070,235950024,57481752,56412046,178468272,22450330,588039664,506748544,81291120,270707157,236041387,1196839698,1156984240,39855458,275076038,881908202
Kanha,Ranthambore,Kanha-Ranthambore,BEN_CI4,BEN_NW9,339167520,284616734,120750093,54550786,163866641,37951077,588039664,506748544,81291120,270707157,236041387,1246521228,1203200533,43320695,216389572,986810961
Kanha,Ranthambore,Kanha-Ranthambore,BEN_CI5,BEN_NW10,252175960,194444468,26097934,57731492,168346534,16773799,447217937,358814659,88403278,289122614,69692045,1266198710,1229664069,36534641,328923565,900740504
Kanha,Ranthambore,Kanha-Ranthambore,BEN_CI5,BEN_NW11,193402553,145233949,20055342,48168604,125178607,17984870,447217937,358814659,88403278,289122614,69692045,997123987,950413379,46710608,263905963,686507416
Kanha,Ranthambore,Kanha-Ranthambore,BEN_CI5,BEN_NW12,254621271,199271182,35429240,55350089,163841942,19563953,447217937,358814659,88403278,289122614,69692045,1267506856,1231795407,35711449,227052846,1004742561
Kanha,Ranthambore,Kanha-Ranthambore,BEN_CI5,BEN_NW13,234153547,178130140,21982086,56023407,156148054,17172049,447217937,358814659,88403278,289122614,69692045,1183131254,1138285233,44846021,344174628,794110605
Kanha,Ranthambore,Kanha-Ranthambore,BEN_CI5,BEN_NW14,248871042,193375334,26064671,55495708,167310663,17756662,447217937,358814659,88403278,289122614,69692045,1235716540,1190952996,44763544,177541519,1013411477
Kanha,Ranthambore,Kanha-Ranthambore,BEN_CI5,BEN_NW17,228806884,177581201,21511807,51225683,156069394,16951975,447217937,358814659,88403278,289122614,69692045,1116321554,1085802823,30518731,256140006,829662817
Kanha,Ranthambore,Kanha-Ranthambore,BEN_CI5,BEN_NW18,271800674,213146071,30439778,58654603,182706293,15089502,447217937,358814659,88403278,289122614,69692045,1339364699,1300736006,38628693,242877521,1057858485
Kanha,Ranthambore,Kanha-Ranthambore,BEN_CI5,BEN_NW19,224088434,172731859,27229398,51356575,145502461,9074881,447217937,358814659,88403278,289122614,69692045,1081768306,1036331080,45437226,232322355,804008725
Kanha,Ranthambore,Kanha-Ranthambore,BEN_CI5,BEN_NW20,230832619,168897661,13178048,61934958,155719613,8101265,447217937,358814659,88403278,289122614,69692045,1086271749,1022278981,63992768,541693814,480585167
Kanha,Ranthambore,Kanha-Ranthambore,BEN_CI5,BEN_NW24,232332584,176118697,28257982,56213887,147860715,12043879,447217937,358814659,88403278,289122614,69692045,1159641386,1113494396,46146990,301627698,811866698
Kanha,Ranthambore,Kanha-Ranthambore,BEN_CI5,BEN_NW3,258838436,199436525,39934694,59401911,159501831,20992975,447217937,358814659,88403278,289122614,69692045,1280728709,1240123254,40605455,207797688,1032325566
Kanha,Ranthambore,Kanha-Ranthambore,BEN_CI5,BEN_NW4,244786304,190674065,25337245,54112239,165336820,20353288,447217937,358814659,88403278,289122614,69692045,1219365724,1186222475,33143249,158691252,1027531223
Kanha,Ranthambore,Kanha-Ranthambore,BEN_CI5,BEN_NW5,194694162,143194670,22609387,51499492,120585283,11356379,447217937,358814659,88403278,289122614,69692045,977809134,918585062,59224072,241966240,676618822
Kanha,Ranthambore,Kanha-Ranthambore,BEN_CI5,BEN_NW55,219793296,160286419,19865193,59506877,140421226,11097252,447217937,358814659,88403278,289122614,69692045,1131174741,1073214798,57959943,534097691,539117107
Kanha,Ranthambore,Kanha-Ranthambore,BEN_CI5,BEN_NW57,228131817,158417567,13851546,69714250,144566021,6422720,447217937,358814659,88403278,289122614,69692045,1180288036,1103120235,77167801,638361097,464759138
Kanha,Ranthambore,Kanha-Ranthambore,BEN_CI5,BEN_NW6,207140128,159520626,25872395,47619502,133648231,13256646,447217937,358814659,88403278,289122614,69692045,992143483,946435718,45707765,248527765,697907953
Kanha,Ranthambore,Kanha-Ranthambore,BEN_CI5,BEN_NW8,232398795,178539166,19182729,53859629,159356437,15054416,447217937,358814659,88403278,289122614,69692045,1196839698,1156984240,39855458,275076038,881908202
Kanha,Ranthambore,Kanha-Ranthambore,BEN_CI5,BEN_NW9,258821358,202066296,26313369,56755062,175752927,18752454,447217937,358814659,88403278,289122614,69692045,1246521228,1203200533,43320695,216389572,986810961
Kanha,Ranthambore,Kanha-Ranthambore,BEN_CI6,BEN_NW10,324208626,254533817,69494375,69674809,185039442,40599416,558093435,456569955,101523480,304633087,151936868,1266198710,1229664069,36534641,328923565,900740504
Kanha,Ranthambore,Kanha-Ranthambore,BEN_CI6,BEN_NW11,257104894,200510796,51584373,56594098,148926423,31262870,558093435,456569955,101523480,304633087,151936868,997123987,950413379,46710608,263905963,686507416
Kanha,Ranthambore,Kanha-Ranthambore,BEN_CI6,BEN_NW12,313355463,245497807,63436165,67857656,182061642,22239955,558093435,456569955,101523480,304633087,151936868,1267506856,1231795407,35711449,227052846,1004742561
Kanha,Ranthambore,Kanha-Ranthambore,BEN_CI6,BEN_NW13,303601617,237631971,54700241,65969646,182931730,36773562,558093435,456569955,101523480,304633087,151936868,1183131254,1138285233,44846021,344174628,794110605
Kanha,Ranthambore,Kanha-Ranthambore,BEN_CI6,BEN_NW14,295106018,229787624,67365839,65318394,162421785,31156502,558093435,456569955,101523480,304633087,151936868,1235716540,1190952996,44763544,177541519,1013411477
Kanha,Ranthambore,Kanha-Ranthambore,BEN_CI6,BEN_NW17,253477168,191347709,34722802,62129459,156624907,13379887,558093435,456569955,101523480,304633087,151936868,1116321554,1085802823,30518731,256140006,829662817
Kanha,Ranthambore,Kanha-Ranthambore,BEN_CI6,BEN_NW18,337232755,270572674,76276768,66660081,194295906,33896397,558093435,456569955,101523480,304633087,151936868,1339364699,1300736006,38628693,242877521,1057858485
Kanha,Ranthambore,Kanha-Ranthambore,BEN_CI6,BEN_NW19,260265353,196897656,40272758,63367697,156624898,18484486,558093435,456569955,101523480,304633087,151936868,1081768306,1036331080,45437226,232322355,804008725
Kanha,Ranthambore,Kanha-Ranthambore,BEN_CI6,BEN_NW20,281113454,211371973,39858859,69741481,171513114,32588782,558093435,456569955,101523480,304633087,151936868,1086271749,1022278981,63992768,541693814,480585167
Kanha,Ranthambore,Kanha-Ranthambore,BEN_CI6,BEN_NW24,282559302,215173547,50863766,67385755,164309781,29419952,558093435,456569955,101523480,304633087,151936868,1159641386,1113494396,46146990,301627698,811866698
Kanha,Ranthambore,Kanha-Ranthambore,BEN_CI6,BEN_NW3,310909978,242065015,59910433,68844963,182154582,31714631,558093435,456569955,101523480,304633087,151936868,1280728709,1240123254,40605455,207797688,1032325566
Kanha,Ranthambore,Kanha-Ranthambore,BEN_CI6,BEN_NW4,296789596,231391150,62901116,65398446,168490034,25267808,558093435,456569955,101523480,304633087,151936868,1219365724,1186222475,33143249,158691252,1027531223
Kanha,Ranthambore,Kanha-Ranthambore,BEN_CI6,BEN_NW5,255046833,195956153,48655322,59090680,147300831,25720269,558093435,456569955,101523480,304633087,151936868,977809134,918585062,59224072,241966240,676618822
Kanha,Ranthambore,Kanha-Ranthambore,BEN_CI6,BEN_NW55,286267332,215262616,36885972,71004716,178376644,27262815,558093435,456569955,101523480,304633087,151936868,1131174741,1073214798,57959943,534097691,539117107
Kanha,Ranthambore,Kanha-Ranthambore,BEN_CI6,BEN_NW57,323026368,243447235,40766449,79579133,202680786,27456973,558093435,456569955,101523480,304633087,151936868,1180288036,1103120235,77167801,638361097,464759138
Kanha,Ranthambore,Kanha-Ranthambore,BEN_CI6,BEN_NW6,254815494,198641694,48006194,56173800,150635500,20988761,558093435,456569955,101523480,304633087,151936868,992143483,946435718,45707765,248527765,697907953
Kanha,Ranthambore,Kanha-Ranthambore,BEN_CI6,BEN_NW8,288481675,221798691,47242131,66682984,174556560,34236864,558093435,456569955,101523480,304633087,151936868,1196839698,1156984240,39855458,275076038,881908202
Kanha,Ranthambore,Kanha-Ranthambore,BEN_CI6,BEN_NW9,312443690,244823662,68705002,67620028,176118660,36593178,558093435,456569955,101523480,304633087,151936868,1246521228,1203200533,43320695,216389572,986810961
Kanha,Ranthambore,Kanha-Ranthambore,BEN_CI7,BEN_NW10,420572938,398061715,233116129,22511223,164945586,101614792,746271387,730520258,15751129,197580294,532939964,1266198710,1229664069,36534641,328923565,900740504
Kanha,Ranthambore,Kanha-Ranthambore,BEN_CI7,BEN_NW11,330993846,307739953,162034540,23253893,145705413,54621227,746271387,730520258,15751129,197580294,532939964,997123987,950413379,46710608,263905963,686507416
Kanha,Ranthambore,Kanha-Ranthambore,BEN_CI7,BEN_NW12,434577551,412731090,238574880,21846461,174156210,58525087,746271387,730520258,15751129,197580294,532939964,1267506856,1231795407,35711449,227052846,1004742561
Kanha,Ranthambore,Kanha-Ranthambore,BEN_CI7,BEN_NW13,386775625,365951506,169123460,20824119,196828046,80098029,746271387,730520258,15751129,197580294,532939964,1183131254,1138285233,44846021,344174628,794110605
Kanha,Ranthambore,Kanha-Ranthambore,BEN_CI7,BEN_NW14,447474412,426284012,273354978,21190400,152929034,52110613,746271387,730520258,15751129,197580294,532939964,1235716540,1190952996,44763544,177541519,1013411477
Kanha,Ranthambore,Kanha-Ranthambore,BEN_CI7,BEN_NW17,377899943,361094943,203043071,16805000,158051872,59947239,746271387,730520258,15751129,197580294,532939964,1116321554,1085802823,30518731,256140006,829662817
Kanha,Ranthambore,Kanha-Ranthambore,BEN_CI7,BEN_NW18,444931073,423848550,253254703,21082523,170593847,71552751,746271387,730520258,15751129,197580294,532939964,1339364699,1300736006,38628693,242877521,1057858485
Kanha,Ranthambore,Kanha-Ranthambore,BEN_CI7,BEN_NW19,377123861,356128919,209531517,20994942,146597402,60515927,746271387,730520258,15751129,197580294,532939964,1081768306,1036331080,45437226,232322355,804008725
Kanha,Ranthambore,Kanha-Ranthambore,BEN_CI7,BEN_NW20,371585971,339910476,133041978,31675495,206868498,79399776,746271387,730520258,15751129,197580294,532939964,1086271749,1022278981,63992768,541693814,480585167
Kanha,Ranthambore,Kanha-Ranthambore,BEN_CI7,BEN_NW24,405748714,381661396,202157452,24087318,179503944,85900036,746271387,730520258,15751129,197580294,532939964,1159641386,1113494396,46146990,301627698,811866698
Kanha,Ranthambore,Kanha-Ranthambore,BEN_CI7,BEN_NW3,390928643,367578684,197756936,23349959,169821748,58079565,746271387,730520258,15751129,197580294,532939964,1280728709,1240123254,40605455,207797688,1032325566
Kanha,Ranthambore,Kanha-Ranthambore,BEN_CI7,BEN_NW4,384910166,362455031,215248326,22455135,147206705,42983408,746271387,730520258,15751129,197580294,532939964,1219365724,1186222475,33143249,158691252,1027531223
Kanha,Ranthambore,Kanha-Ranthambore,BEN_CI7,BEN_NW5,323768709,297497259,152950918,26271450,144546341,41655860,746271387,730520258,15751129,197580294,532939964,977809134,918585062,59224072,241966240,676618822
Kanha,Ranthambore,Kanha-Ranthambore,BEN_CI7,BEN_NW55,369078253,343423093,123731770,25655160,219691323,66667594,746271387,730520258,15751129,197580294,532939964,1131174741,1073214798,57959943,534097691,539117107
Kanha,Ranthambore,Kanha-Ranthambore,BEN_CI7,BEN_NW57,385822018,349503916,106150514,36318102,243353402,73346752,746271387,730520258,15751129,197580294,532939964,1180288036,1103120235,77167801,638361097,464759138
Kanha,Ranthambore,Kanha-Ranthambore,BEN_CI7,BEN_NW6,349462621,327911566,198070005,21551055,129841561,49868499,746271387,730520258,15751129,197580294,532939964,992143483,946435718,45707765,248527765,697907953
Kanha,Ranthambore,Kanha-Ranthambore,BEN_CI7,BEN_NW8,408597406,383738734,216004467,24858672,167734267,76076801,746271387,730520258,15751129,197580294,532939964,1196839698,1156984240,39855458,275076038,881908202
Kanha,Ranthambore,Kanha-Ranthambore,BEN_CI7,BEN_NW9,428221421,405647082,244139159,22574339,161507923,63080695,746271387,730520258,15751129,197580294,532939964,1246521228,1203200533,43320695,216389572,986810961
Kanha,Wayanad,Kanha-Wayanad,BEN_CI15,BEN_SI1,223180896,152089871,17818430,71091025,134271441,13510772,558426844,440368350,118058494,313676252,126692098,897358653,799698739,97659914,345341326,454357413
Kanha,Wayanad,Kanha-Wayanad,BEN_CI15,BEN_SI11,163014081,123056650,24749912,39957431,98306738,18480976,558426844,440368350,118058494,313676252,126692098,641166204,612648765,28517439,241001807,371646958
Kanha,Wayanad,Kanha-Wayanad,BEN_CI15,BEN_SI2,160430091,124803346,22510924,35626745,102292422,10082853,558426844,440368350,118058494,313676252,126692098,650993225,648515374,2477851,140667619,507847755
Kanha,Wayanad,Kanha-Wayanad,BEN_CI15,BEN_SI3,230465593,161602967,12354386,68862626,149248581,12354386,558426844,440368350,118058494,313676252,126692098,931565359,847325564,84239795,345974583,501350981
Kanha,Wayanad,Kanha-Wayanad,BEN_CI15,BEN_SI4,289345512,213223654,54832925,76121858,158390729,27875185,558426844,440368350,118058494,313676252,126692098,1109312253,1030580255,78731998,302255092,728325163
Kanha,Wayanad,Kanha-Wayanad,BEN_CI15,BEN_SI6,235055732,165602648,15349816,69453084,150252832,15349816,558426844,440368350,118058494,313676252,126692098,951080464,864453508,86626956,319674486,544779022
Kanha,Wayanad,Kanha-Wayanad,BEN_CI15,BEN_SI7,233134014,162279942,15218020,70854072,147061922,12449020,558426844,440368350,118058494,313676252,126692098,942430262,853584663,88845599,335397181,518187482
Kanha,Wayanad,Kanha-Wayanad,BEN_CI15,BEN_SI8,288328753,211057548,55744609,77271205,155312939,30778852,558426844,440368350,118058494,313676252,126692098,1108177315,1029030472,79146843,300308119,728722353
Kanha,Wayanad,Kanha-Wayanad,BEN_CI15,BEN_SI9,214972274,148570595,22310885,66401679,126259710,16028747,558426844,440368350,118058494,313676252,126692098,849233213,745820153,103413060,339499389,406320764
Kanha,Wayanad,Kanha-Wayanad,BEN_CI16,BEN_SI1,400800096,332427521,144034030,68372575,188393491,56983388,941465693,865515372,75950321,260165870,605349502,897358653,799698739,97659914,345341326,454357413
Kanha,Wayanad,Kanha-Wayanad,BEN_CI16,BEN_SI11,256842149,222796753,71791885,34045396,151004868,27559531,941465693,865515372,75950321,260165870,605349502,641166204,612648765,28517439,241001807,371646958
Kanha,Wayanad,Kanha-Wayanad,BEN_CI16,BEN_SI2,275068117,253016037,128619954,22052080,124396083,48251082,941465693,865515372,75950321,260165870,605349502,650993225,648515374,2477851,140667619,507847755
Kanha,Wayanad,Kanha-Wayanad,BEN_CI16,BEN_SI3,401412354,334063055,136423264,67349299,197639791,59057584,941465693,865515372,75950321,260165870,605349502,931565359,847325564,84239795,345974583,501350981
Kanha,Wayanad,Kanha-Wayanad,BEN_CI16,BEN_SI4,457147801,388549272,193816710,68598529,194732562,63062029,941465693,865515372,75950321,260165870,605349502,1109312253,1030580255,78731998,302255092,728325163
Kanha,Wayanad,Kanha-Wayanad,BEN_CI16,BEN_SI6,414423483,347828979,154838336,66594504,192990643,66637609,941465693,865515372,75950321,260165870,605349502,951080464,864453508,86626956,319674486,544779022
Kanha,Wayanad,Kanha-Wayanad,BEN_CI16,BEN_SI7,405316803,334686166,139955444,70630637,194730722,53157653,941465693,865515372,75950321,260165870,605349502,942430262,853584663,88845599,335397181,518187482
Kanha,Wayanad,Kanha-Wayanad,BEN_CI16,BEN_SI8,457109470,388537405,187705954,68572065,200831451,55682467,941465693,865515372,75950321,260165870,605349502,1108177315,1029030472,79146843,300308119,728722353
Kanha,Wayanad,Kanha-Wayanad,BEN_CI16,BEN_SI9,355230296,288542216,110680320,66688080,177861896,44786989,941465693,865515372,75950321,260165870,605349502,849233213,745820153,103413060,339499389,406320764
Kanha,Wayanad,Kanha-Wayanad,BEN_CI18,BEN_SI1,216376235,145787251,27890080,70588984,117897171,18741165,531335982,416398696,114937286,280261230,136137466,897358653,799698739,97659914,345341326,454357413
Kanha,Wayanad,Kanha-Wayanad,BEN_CI18,BEN_SI11,137211940,94635983,5963478,42575957,88672505,5963478,531335982,416398696,114937286,280261230,136137466,641166204,612648765,28517439,241001807,371646958
Kanha,Wayanad,Kanha-Wayanad,BEN_CI18,BEN_SI2,166660519,131545584,36572939,35114935,94972645,18613415,531335982,416398696,114937286,280261230,136137466,650993225,648515374,2477851,140667619,507847755
Kanha,Wayanad,Kanha-Wayanad,BEN_CI18,BEN_SI3,221409177,153140082,18906833,68269095,134233249,18906833,531335982,416398696,114937286,280261230,136137466,931565359,847325564,84239795,345974583,501350981
Kanha,Wayanad,Kanha-Wayanad,BEN_CI18,BEN_SI4,246563109,172280392,25735273,74282717,146545119,18598295,531335982,416398696,114937286,280261230,136137466,1109312253,1030580255,78731998,302255092,728325163
Kanha,Wayanad,Kanha-Wayanad,BEN_CI18,BEN_SI6,225003075,155428251,16880226,69574824,138548025,14145826,531335982,416398696,114937286,280261230,136137466,951080464,864453508,86626956,319674486,544779022
Kanha,Wayanad,Kanha-Wayanad,BEN_CI18,BEN_SI7,223195981,153339922,21866970,69856059,131472952,21866970,531335982,416398696,114937286,280261230,136137466,942430262,853584663,88845599,335397181,518187482
Kanha,Wayanad,Kanha-Wayanad,BEN_CI18,BEN_SI8,246874159,173246957,24206103,73627202,149040854,15961146,531335982,416398696,114937286,280261230,136137466,1108177315,1029030472,79146843,300308119,728722353
Kanha,Wayanad,Kanha-Wayanad,BEN_CI18,BEN_SI9,210631149,144502831,26984087,66128318,117518744,21763476,531335982,416398696,114937286,280261230,136137466,849233213,745820153,103413060,339499389,406320764
Kanha,Wayanad,Kanha-Wayanad,BEN_CI19,BEN_SI1,139615729,78323630,,61292099,78323630,,370653731,261143653,109510078,241812071,19331582,897358653,799698739,97659914,345341326,454357413
Kanha,Wayanad,Kanha-Wayanad,BEN_CI19,BEN_SI11,100705757,63173818,2232276,37531939,60941542,2232276,370653731,261143653,109510078,241812071,19331582,641166204,612648765,28517439,241001807,371646958
Kanha,Wayanad,Kanha-Wayanad,BEN_CI19,BEN_SI2,110745063,78670373,2758467,32074690,75911906,2758467,370653731,261143653,109510078,241812071,19331582,650993225,648515374,2477851,140667619,507847755
Kanha,Wayanad,Kanha-Wayanad,BEN_CI19,BEN_SI3,163086176,101186708,2948374,61899468,98238334,2948374,370653731,261143653,109510078,241812071,19331582,931565359,847325564,84239795,345974583,501350981
Kanha,Wayanad,Kanha-Wayanad,BEN_CI19,BEN_SI4,199376115,131690383,7303337,67685732,124387046,7303337,370653731,261143653,109510078,241812071,19331582,1109312253,1030580255,78731998,302255092,728325163
Kanha,Wayanad,Kanha-Wayanad,BEN_CI19,BEN_SI6,162637185,99538883,2226310,63098302,97312573,2226310,370653731,261143653,109510078,241812071,19331582,951080464,864453508,86626956,319674486,544779022
Kanha,Wayanad,Kanha-Wayanad,BEN_CI19,BEN_SI7,163943445,100505288,2948374,63438157,97556914,2948374,370653731,261143653,109510078,241812071,19331582,942430262,853584663,88845599,335397181,518187482
Kanha,Wayanad,Kanha-Wayanad,BEN_CI19,BEN_SI8,198538300,131189764,6153911,67348536,125035853,6153911,370653731,261143653,109510078,241812071,19331582,1108177315,1029030472,79146843,300308119,728722353
Kanha,Wayanad,Kanha-Wayanad,BEN_CI19,BEN_SI9,137039459,77497717,2209055,59541742,75288662,2209055,370653731,261143653,109510078,241812071,19331582,849233213,745820153,103413060,339499389,406320764
Kanha,Wayanad,Kanha-Wayanad,BEN_CI3,BEN_SI1,238923488,168651617,31408675,70271871,137242942,5798264,399948004,398407865,1540139,114426239,283981626,897358653,799698739,97659914,345341326,454357413
Kanha,Wayanad,Kanha-Wayanad,BEN_CI3,BEN_SI11,168756234,128977723,25532141,39778511,103445582,16876271,399948004,398407865,1540139,114426239,283981626,641166204,612648765,28517439,241001807,371646958
Kanha,Wayanad,Kanha-Wayanad,BEN_CI3,BEN_SI2,196532930,159789755,59628142,36743175,100161613,23366857,399948004,398407865,1540139,114426239,283981626,650993225,648515374,2477851,140667619,507847755
Kanha,Wayanad,Kanha-Wayanad,BEN_CI3,BEN_SI3,250324995,181800021,37352126,68524974,144447895,19366331,399948004,398407865,1540139,114426239,283981626,931565359,847325564,84239795,345974583,501350981
Kanha,Wayanad,Kanha-Wayanad,BEN_CI3,BEN_SI4,300969558,224493383,54841085,76476175,169652298,24882968,399948004,398407865,1540139,114426239,283981626,1109312253,1030580255,78731998,302255092,728325163
Kanha,Wayanad,Kanha-Wayanad,BEN_CI3,BEN_SI6,271253629,199816629,53770038,71437000,146046591,21707098,399948004,398407865,1540139,114426239,283981626,951080464,864453508,86626956,319674486,544779022
Kanha,Wayanad,Kanha-Wayanad,BEN_CI3,BEN_SI7,255412195,183994803,38493754,71417392,145501049,16434007,399948004,398407865,1540139,114426239,283981626,942430262,853584663,88845599,335397181,518187482
Kanha,Wayanad,Kanha-Wayanad,BEN_CI3,BEN_SI8,300235209,224000527,57181880,76234682,166818647,21213372,399948004,398407865,1540139,114426239,283981626,1108177315,1029030472,79146843,300308119,728722353
Kanha,Wayanad,Kanha-Wayanad,BEN_CI3,BEN_SI9,219926856,151011545,17346645,68915311,133664900,10228989,399948004,398407865,1540139,114426239,283981626,849233213,745820153,103413060,339499389,406320764
Kanha,Wayanad,Kanha-Wayanad,BEN_CI4,BEN_SI1,247107781,189583789,58504416,57523992,131079373,24519569,588039664,506748544,81291120,270707157,236041387,897358653,799698739,97659914,345341326,454357413
Kanha,Wayanad,Kanha-Wayanad,BEN_CI4,BEN_SI11,169063725,136634902,30969430,32428823,105665472,16011621,588039664,506748544,81291120,270707157,236041387,641166204,612648765,28517439,241001807,371646958
Kanha,Wayanad,Kanha-Wayanad,BEN_CI4,BEN_SI2,180026124,156138886,72898873,23887238,83240013,16881626,588039664,506748544,81291120,270707157,236041387,650993225,648515374,2477851,140667619,507847755
Kanha,Wayanad,Kanha-Wayanad,BEN_CI4,BEN_SI3,240906056,184863546,38940697,56042510,145922849,24121940,588039664,506748544,81291120,270707157,236041387,931565359,847325564,84239795,345974583,501350981
Kanha,Wayanad,Kanha-Wayanad,BEN_CI4,BEN_SI4,277984398,217119617,59147634,60864781,157971983,45234617,588039664,506748544,81291120,270707157,236041387,1109312253,1030580255,78731998,302255092,728325163
Kanha,Wayanad,Kanha-Wayanad,BEN_CI4,BEN_SI6,262701734,207127990,65535773,55573744,141592217,31461918,588039664,506748544,81291120,270707157,236041387,951080464,864453508,86626956,319674486,544779022
Kanha,Wayanad,Kanha-Wayanad,BEN_CI4,BEN_SI7,242854451,185653162,47765236,57201289,137887926,27699201,588039664,506748544,81291120,270707157,236041387,942430262,853584663,88845599,335397181,518187482
Kanha,Wayanad,Kanha-Wayanad,BEN_CI4,BEN_SI8,277982507,216625658,55837387,61356849,160788271,37790616,588039664,506748544,81291120,270707157,236041387,1108177315,1029030472,79146843,300308119,728722353
Kanha,Wayanad,Kanha-Wayanad,BEN_CI4,BEN_SI9,223353444,169602435,34453640,53751009,135148795,20157526,588039664,506748544,81291120,270707157,236041387,849233213,745820153,103413060,339499389,406320764
Kanha,Wayanad,Kanha-Wayanad,BEN_CI5,BEN_SI1,177699801,122972327,8416831,54727474,114555496,3604980,447217937,358814659,88403278,289122614,69692045,897358653,799698739,97659914,345341326,454357413
Kanha,Wayanad,Kanha-Wayanad,BEN_CI5,BEN_SI11,126757445,94372912,7615139,32384533,86757773,5261878,447217937,358814659,88403278,289122614,69692045,641166204,612648765,28517439,241001807,371646958
Kanha,Wayanad,Kanha-Wayanad,BEN_CI5,BEN_SI2,121618850,93246139,11986664,28372711,81259475,9109733,447217937,358814659,88403278,289122614,69692045,650993225,648515374,2477851,140667619,507847755
Kanha,Wayanad,Kanha-Wayanad,BEN_CI5,BEN_SI3,187917576,133405252,12186568,54512324,121218684,10138184,447217937,358814659,88403278,289122614,69692045,931565359,847325564,84239795,345974583,501350981
Kanha,Wayanad,Kanha-Wayanad,BEN_CI5,BEN_SI4,226554142,169918315,27774820,56635827,142143495,13066234,447217937,358814659,88403278,289122614,69692045,1109312253,1030580255,78731998,302255092,728325163
Kanha,Wayanad,Kanha-Wayanad,BEN_CI5,BEN_SI6,196447769,145148347,14434924,51299422,130713423,5986073,447217937,358814659,88403278,289122614,69692045,951080464,864453508,86626956,319674486,544779022
Kanha,Wayanad,Kanha-Wayanad,BEN_CI5,BEN_SI7,190423030,133721415,12377934,56701615,121343481,10329550,447217937,358814659,88403278,289122614,69692045,942430262,853584663,88845599,335397181,518187482
Kanha,Wayanad,Kanha-Wayanad,BEN_CI5,BEN_SI8,227008694,170655272,24778900,56353422,145876372,12133829,447217937,358814659,88403278,289122614,69692045,1108177315,1029030472,79146843,300308119,728722353
Kanha,Wayanad,Kanha-Wayanad,BEN_CI5,BEN_SI9,167391101,113103826,9559922,54287275,103543904,7511538,447217937,358814659,88403278,289122614,69692045,849233213,745820153,103413060,339499389,406320764
Kanha,Wayanad,Kanha-Wayanad,BEN_CI6,BEN_SI1,221067784,156363019,24179983,64704765,132183036,15687248,558093435,456569955,101523480,304633087,151936868,897358653,799698739,97659914,345341326,454357413
Kanha,Wayanad,Kanha-Wayanad,BEN_CI6,BEN_SI11,164597573,127283901,30444032,37313672,96839869,19088954,558093435,456569955,101523480,304633087,151936868,641166204,612648765,28517439,241001807,371646958
Kanha,Wayanad,Kanha-Wayanad,BEN_CI6,BEN_SI2,152992375,122248174,20625398,30744201,101622776,13040538,558093435,456569955,101523480,304633087,151936868,650993225,648515374,2477851,140667619,507847755
Kanha,Wayanad,Kanha-Wayanad,BEN_CI6,BEN_SI3,232706925,169883452,40402992,62823473,129480460,15597901,558093435,456569955,101523480,304633087,151936868,931565359,847325564,84239795,345974583,501350981
Kanha,Wayanad,Kanha-Wayanad,BEN_CI6,BEN_SI4,281325551,214458693,50977659,66866858,163481034,20621281,558093435,456569955,101523480,304633087,151936868,1109312253,1030580255,78731998,302255092,728325163
Kanha,Wayanad,Kanha-Wayanad,BEN_CI6,BEN_SI6,244911055,182664390,48150494,62246665,134513896,32041958,558093435,456569955,101523480,304633087,151936868,951080464,864453508,86626956,319674486,544779022
Kanha,Wayanad,Kanha-Wayanad,BEN_CI6,BEN_SI7,234862128,169208557,39580994,65653571,129627563,11419660,558093435,456569955,101523480,304633087,151936868,942430262,853584663,88845599,335397181,518187482
Kanha,Wayanad,Kanha-Wayanad,BEN_CI6,BEN_SI8,281155728,213927651,52538494,67228077,161389157,24112619,558093435,456569955,101523480,304633087,151936868,1108177315,1029030472,79146843,300308119,728722353
Kanha,Wayanad,Kanha-Wayanad,BEN_CI6,BEN_SI9,226108763,168445734,41542272,57663029,126903462,20019766,558093435,456569955,101523480,304633087,151936868,849233213,745820153,103413060,339499389,406320764
Kanha,Wayanad,Kanha-Wayanad,BEN_CI7,BEN_SI1,326169649,290787484,146193072,35382165,144594412,34043852,746271387,730520258,15751129,197580294,532939964,897358653,799698739,97659914,345341326,454357413
Kanha,Wayanad,Kanha-Wayanad,BEN_CI7,BEN_SI11,226829036,215727479,98937670,11101557,116789809,36722959,746271387,730520258,15751129,197580294,532939964,641166204,612648765,28517439,241001807,371646958
Kanha,Wayanad,Kanha-Wayanad,BEN_CI7,BEN_SI2,218088567,211069959,114568570,7018608,96501389,21027753,746271387,730520258,15751129,197580294,532939964,650993225,648515374,2477851,140667619,507847755
Kanha,Wayanad,Kanha-Wayanad,BEN_CI7,BEN_SI3,303739053,268732633,111393160,35006420,157339473,43784545,746271387,730520258,15751129,197580294,532939964,931565359,847325564,84239795,345974583,501350981
Kanha,Wayanad,Kanha-Wayanad,BEN_CI7,BEN_SI4,393392766,363472163,198275980,29920603,165196183,53823755,746271387,730520258,15751129,197580294,532939964,1109312253,1030580255,78731998,302255092,728325163
Kanha,Wayanad,Kanha-Wayanad,BEN_CI7,BEN_SI6,300358113,264711068,100913556,35647045,163797512,38351797,746271387,730520258,15751129,197580294,532939964,951080464,864453508,86626956,319674486,544779022
Kanha,Wayanad,Kanha-Wayanad,BEN_CI7,BEN_SI7,306870544,270444529,110896818,36426015,159547711,41971591,746271387,730520258,15751129,197580294,532939964,942430262,853584663,88845599,335397181,518187482
Kanha,Wayanad,Kanha-Wayanad,BEN_CI7,BEN_SI8,393237846,363841811,203908294,29396035,159933517,45939329,746271387,730520258,15751129,197580294,532939964,1108177315,1029030472,79146843,300308119,728722353
Kanha,Wayanad,Kanha-Wayanad,BEN_CI7,BEN_SI9,277249075,238964001,95185548,38285074,143778453,36336388,746271387,730520258,15751129,197580294,532939964,849233213,745820153,103413060,339499389,406320764
Kanha,Zoo,Kanha-Zoo,BEN_CI15,ZSB_01,178259380,118724130,10388573,59535250,108335557,10388573,558426844,440368350,118058494,313676252,126692098,723092447,635855373,87237074,256023333,379832040
Kanha,Zoo,Kanha-Zoo,BEN_CI15,ZSB_02,235306407,169643063,29198713,65663344,140444350,14730630,558426844,440368350,118058494,313676252,126692098,942790346,865053483,77736863,260820720,604232763
Kanha,Zoo,Kanha-Zoo,BEN_CI15,ZSB_03,219727367,158436339,21075502,61291028,137360837,9911599,558426844,440368350,118058494,313676252,126692098,892317758,827799945,64517813,241409256,586390689
Kanha,Zoo,Kanha-Zoo,BEN_CI15,ZSB_04,231490101,171595076,38679516,59895025,132915560,21483298,558426844,440368350,118058494,313676252,126692098,867386629,799476794,67909835,302302125,497174669
Kanha,Zoo,Kanha-Zoo,BEN_CI15,ZSB_05,224746977,158616390,40051778,66130587,118564612,17914944,558426844,440368350,118058494,313676252,126692098,864922054,784467789,80454265,246263826,538203963
Kanha,Zoo,Kanha-Zoo,BEN_CI16,ZSB_01,317473553,259347801,119075230,58125752,140272571,30396776,941465693,865515372,75950321,260165870,605349502,723092447,635855373,87237074,256023333,379832040
Kanha,Zoo,Kanha-Zoo,BEN_CI16,ZSB_02,417351945,357470076,165762753,59881869,191707323,56897912,941465693,865515372,75950321,260165870,605349502,942790346,865053483,77736863,260820720,604232763
Kanha,Zoo,Kanha-Zoo,BEN_CI16,ZSB_03,408974496,357207366,174308062,51767130,182899304,56016363,941465693,865515372,75950321,260165870,605349502,892317758,827799945,64517813,241409256,586390689
Kanha,Zoo,Kanha-Zoo,BEN_CI16,ZSB_04,388310597,337009435,151738457,51301162,185270978,59996425,941465693,865515372,75950321,260165870,605349502,867386629,799476794,67909835,302302125,497174669
Kanha,Zoo,Kanha-Zoo,BEN_CI16,ZSB_05,339237787,272095084,97423627,67142703,174671457,32589825,941465693,865515372,75950321,260165870,605349502,864922054,784467789,80454265,246263826,538203963
Kanha,Zoo,Kanha-Zoo,BEN_CI18,ZSB_01,162499566,105289099,8947299,57210467,96341800,5556673,531335982,416398696,114937286,280261230,136137466,723092447,635855373,87237074,256023333,379832040
Kanha,Zoo,Kanha-Zoo,BEN_CI18,ZSB_02,218073965,154226281,25419690,63847684,128806591,23290778,531335982,416398696,114937286,280261230,136137466,942790346,865053483,77736863,260820720,604232763
Kanha,Zoo,Kanha-Zoo,BEN_CI18,ZSB_03,214002385,156235137,42198011,57767248,114037126,16719026,531335982,416398696,114937286,280261230,136137466,892317758,827799945,64517813,241409256,586390689
Kanha,Zoo,Kanha-Zoo,BEN_CI18,ZSB_04,207592228,149476769,24745354,58115459,124731415,12203947,531335982,416398696,114937286,280261230,136137466,867386629,799476794,67909835,302302125,497174669
Kanha,Zoo,Kanha-Zoo,BEN_CI18,ZSB_05,207908005,144281303,25874282,63626702,118407021,23387982,531335982,416398696,114937286,280261230,136137466,864922054,784467789,80454265,246263826,538203963
Kanha,Zoo,Kanha-Zoo,BEN_CI19,ZSB_01,106133545,58124155,2640990,48009390,55483165,2640990,370653731,261143653,109510078,241812071,19331582,723092447,635855373,87237074,256023333,379832040
Kanha,Zoo,Kanha-Zoo,BEN_CI19,ZSB_02,153395185,96333014,1177170,57062171,95155844,1177170,370653731,261143653,109510078,241812071,19331582,942790346,865053483,77736863,260820720,604232763
Kanha,Zoo,Kanha-Zoo,BEN_CI19,ZSB_03,148223551,93076699,6555064,55146852,86521635,6555064,370653731,261143653,109510078,241812071,19331582,892317758,827799945,64517813,241409256,586390689
Kanha,Zoo,Kanha-Zoo,BEN_CI19,ZSB_04,141528682,90233359,2261740,51295323,87971619,2261740,370653731,261143653,109510078,241812071,19331582,867386629,799476794,67909835,302302125,497174669
Kanha,Zoo,Kanha-Zoo,BEN_CI19,ZSB_05,157259624,99421446,5134902,57838178,94286544,5134902,370653731,261143653,109510078,241812071,19331582,864922054,784467789,80454265,246263826,538203963
Kanha,Zoo,Kanha-Zoo,BEN_CI3,ZSB_01,210273002,154552458,46900963,55720544,107651495,16902056,399948004,398407865,1540139,114426239,283981626,723092447,635855373,87237074,256023333,379832040
Kanha,Zoo,Kanha-Zoo,BEN_CI3,ZSB_02,281154217,219392116,73656256,61762101,145735860,31828112,399948004,398407865,1540139,114426239,283981626,942790346,865053483,77736863,260820720,604232763
Kanha,Zoo,Kanha-Zoo,BEN_CI3,ZSB_03,257620865,196615933,65995175,61004932,130620758,32868672,399948004,398407865,1540139,114426239,283981626,892317758,827799945,64517813,241409256,586390689
Kanha,Zoo,Kanha-Zoo,BEN_CI3,ZSB_04,256312738,198234010,48729085,58078728,149504925,23358767,399948004,398407865,1540139,114426239,283981626,867386629,799476794,67909835,302302125,497174669
Kanha,Zoo,Kanha-Zoo,BEN_CI3,ZSB_05,237786534,171401441,38500636,66385093,132900805,27175792,399948004,398407865,1540139,114426239,283981626,864922054,784467789,80454265,246263826,538203963
Kanha,Zoo,Kanha-Zoo,BEN_CI4,ZSB_01,189478474,141140514,37893313,48337960,103247201,12914686,588039664,506748544,81291120,270707157,236041387,723092447,635855373,87237074,256023333,379832040
Kanha,Zoo,Kanha-Zoo,BEN_CI4,ZSB_02,261013950,212143625,69532843,48870325,142610782,32015581,588039664,506748544,81291120,270707157,236041387,942790346,865053483,77736863,260820720,604232763
Kanha,Zoo,Kanha-Zoo,BEN_CI4,ZSB_03,247597808,201147378,81452151,46450430,119695227,20945051,588039664,506748544,81291120,270707157,236041387,892317758,827799945,64517813,241409256,586390689
Kanha,Zoo,Kanha-Zoo,BEN_CI4,ZSB_04,242828624,197060936,70296270,45767688,126764666,36690835,588039664,506748544,81291120,270707157,236041387,867386629,799476794,67909835,302302125,497174669
Kanha,Zoo,Kanha-Zoo,BEN_CI4,ZSB_05,224109158,174330005,53711334,49779153,120618671,20098627,588039664,506748544,81291120,270707157,236041387,864922054,784467789,80454265,246263826,538203963
Kanha,Zoo,Kanha-Zoo,BEN_CI5,ZSB_01,143448708,96424684,8903679,47024024,87521005,4308282,447217937,358814659,88403278,289122614,69692045,723092447,635855373,87237074,256023333,379832040
Kanha,Zoo,Kanha-Zoo,BEN_CI5,ZSB_02,197522060,148927064,23238881,48594996,125688183,16331259,447217937,358814659,88403278,289122614,69692045,942790346,865053483,77736863,260820720,604232763
Kanha,Zoo,Kanha-Zoo,BEN_CI5,ZSB_03,184627971,136439578,14538325,48188393,121901253,12257606,447217937,358814659,88403278,289122614,69692045,892317758,827799945,64517813,241409256,586390689
Kanha,Zoo,Kanha-Zoo,BEN_CI5,ZSB_04,169902001,124359230,11581395,45542771,112777835,11581395,447217937,358814659,88403278,289122614,69692045,867386629,799476794,67909835,302302125,497174669
Kanha,Zoo,Kanha-Zoo,BEN_CI5,ZSB_05,175555624,124654181,15557741,50901443,109096440,10714001,447217937,358814659,88403278,289122614,69692045,864922054,784467789,80454265,246263826,538203963
Kanha,Zoo,Kanha-Zoo,BEN_CI6,ZSB_01,181156252,127359035,22830377,53797217,104528658,15382215,558093435,456569955,101523480,304633087,151936868,723092447,635855373,87237074,256023333,379832040
Kanha,Zoo,Kanha-Zoo,BEN_CI6,ZSB_02,247444461,188992147,38093850,58452314,150898297,30339822,558093435,456569955,101523480,304633087,151936868,942790346,865053483,77736863,260820720,604232763
Kanha,Zoo,Kanha-Zoo,BEN_CI6,ZSB_03,226536379,170279260,42431723,56257119,127847537,28876240,558093435,456569955,101523480,304633087,151936868,892317758,827799945,64517813,241409256,586390689
Kanha,Zoo,Kanha-Zoo,BEN_CI6,ZSB_04,232107788,180415154,51437203,51692634,128977951,36020861,558093435,456569955,101523480,304633087,151936868,867386629,799476794,67909835,302302125,497174669
Kanha,Zoo,Kanha-Zoo,BEN_CI6,ZSB_05,219781888,159641159,33344186,60140729,126296973,19148851,558093435,456569955,101523480,304633087,151936868,864922054,784467789,80454265,246263826,538203963
Kanha,Zoo,Kanha-Zoo,BEN_CI7,ZSB_01,221015387,189932290,75386770,31083097,114545520,25373656,746271387,730520258,15751129,197580294,532939964,723092447,635855373,87237074,256023333,379832040
Kanha,Zoo,Kanha-Zoo,BEN_CI7,ZSB_02,343595459,315907838,192997050,27687621,122910788,56646022,746271387,730520258,15751129,197580294,532939964,942790346,865053483,77736863,260820720,604232763
Kanha,Zoo,Kanha-Zoo,BEN_CI7,ZSB_03,304551985,281851185,143694665,22700800,138156520,43417293,746271387,730520258,15751129,197580294,532939964,892317758,827799945,64517813,241409256,586390689
Kanha,Zoo,Kanha-Zoo,BEN_CI7,ZSB_04,314995178,290405990,141887052,24589188,148518938,62790139,746271387,730520258,15751129,197580294,532939964,867386629,799476794,67909835,302302125,497174669
Kanha,Zoo,Kanha-Zoo,BEN_CI7,ZSB_05,251540783,219699068,83595603,31841715,136103465,22798024,746271387,730520258,15751129,197580294,532939964,864922054,784467789,80454265,246263826,538203963
Kaziranga,Chandrapur,Kaziranga-Chandrapur,BEN_NE1,BEN_CI2,157453788,111644153,14664880,45809635,96979273,7234310,560246780,423100976,137145804,256700947,166400029,674364895,657438378,16926517,229909737,427528641
Kaziranga,Chandrapur,Kaziranga-Chandrapur,BEN_NE2,BEN_CI2,366459890,334077339,162563400,32382551,171513939,59817301,1250511108,1174630426,75880682,233913209,940717217,674364895,657438378,16926517,229909737,427528641
Kaziranga,Chandrapur,Kaziranga-Chandrapur,BEN_NE3,BEN_CI2,302418471,270754655,113237993,31663816,157516662,53082555,1008859852,937520336,71339516,277485474,660034862,674364895,657438378,16926517,229909737,427528641
Kaziranga,Corbett,Kaziranga-Corbett,BEN_NE1,BEN_NOR1,174596929,105624963,13473864,68971966,92151099,13473864,560246780,423100976,137145804,256700947,166400029,689133358,592060124,97073234,396388890,195671234
Kaziranga,Corbett,Kaziranga-Corbett,BEN_NE1,BEN_NOR2,214446627,141741032,31065330,72705595,110675702,12628942,560246780,423100976,137145804,256700947,166400029,872604239,770086648,102517591,315997124,454089524
Kaziranga,Corbett,Kaziranga-Corbett,BEN_NE2,BEN_NOR1,392188392,313398408,84965550,78789984,228432858,65100765,1250511108,1174630426,75880682,233913209,940717217,689133358,592060124,97073234,396388890,195671234
Kaziranga,Corbett,Kaziranga-Corbett,BEN_NE2,BEN_NOR2,462502665,376626199,158680330,85876466,217945869,61713322,1250511108,1174630426,75880682,233913209,940717217,872604239,770086648,102517591,315997124,454089524
Kaziranga,Corbett,Kaziranga-Corbett,BEN_NE3,BEN_NOR1,318847351,249233970,56393720,69613381,192840250,39722514,1008859852,937520336,71339516,277485474,660034862,689133358,592060124,97073234,396388890,195671234
Kaziranga,Corbett,Kaziranga-Corbett,BEN_NE3,BEN_NOR2,365093607,287584843,87017266,77508764,200567577,52419659,1008859852,937520336,71339516,277485474,660034862,872604239,770086648,102517591,315997124,454089524
Kaziranga,Kanha,Kaziranga-Kanha,BEN_NE1,BEN_CI15,143613150,85959879,10216495,57653271,75743384,1340911,560246780,423100976,137145804,256700947,166400029,558426844,440368350,118058494,313676252,126692098
Kaziranga,Kanha,Kaziranga-Kanha,BEN_NE1,BEN_CI16,236956712,164960515,47863412,71996197,117097103,25201606,560246780,423100976,137145804,256700947,166400029,941465693,865515372,75950321,260165870,605349502
Kaziranga,Kanha,Kaziranga-Kanha,BEN_NE1,BEN_CI18,135645696,76804618,2469067,58841078,74335551,2469067,560246780,423100976,137145804,256700947,166400029,531335982,416398696,114937286,280261230,136137466
Kaziranga,Kanha,Kaziranga-Kanha,BEN_NE1,BEN_CI19,99504979,50347861,2492073,49157118,47855788,2492073,560246780,423100976,137145804,256700947,166400029,370653731,261143653,109510078,241812071,19331582
Kaziranga,Kanha,Kaziranga-Kanha,BEN_NE1,BEN_CI3,149797287,89940985,15956927,59856302,73984058,9379426,560246780,423100976,137145804,256700947,166400029,399948004,398407865,1540139,114426239,283981626
Kaziranga,Kanha,Kaziranga-Kanha,BEN_NE1,BEN_CI4,149042368,94384247,12347037,54658121,82037210,4591478,560246780,423100976,137145804,256700947,166400029,588039664,506748544,81291120,270707157,236041387
Kaziranga,Kanha,Kaziranga-Kanha,BEN_NE1,BEN_CI5,117356061,70732105,5375743,46623956,65356362,5375743,560246780,423100976,137145804,256700947,166400029,447217937,358814659,88403278,289122614,69692045
Kaziranga,Kanha,Kaziranga-Kanha,BEN_NE1,BEN_CI6,137930165,80879165,4738110,57051000,76141055,4738110,560246780,423100976,137145804,256700947,166400029,558093435,456569955,101523480,304633087,151936868
Kaziranga,Kanha,Kaziranga-Kanha,BEN_NE1,BEN_CI7,190565854,143409553,44222826,47156301,99186727,23489847,560246780,423100976,137145804,256700947,166400029,746271387,730520258,15751129,197580294,532939964
Kaziranga,Kanha,Kaziranga-Kanha,BEN_NE2,BEN_CI15,324079469,242168209,57569017,81911260,184599192,36822532,1250511108,1174630426,75880682,233913209,940717217,558426844,440368350,118058494,313676252,126692098
Kaziranga,Kanha,Kaziranga-Kanha,BEN_NE2,BEN_CI16,554014011,481164593,290568292,72849418,190596301,73944566,1250511108,1174630426,75880682,233913209,940717217,941465693,865515372,75950321,260165870,605349502
Kaziranga,Kanha,Kaziranga-Kanha,BEN_NE2,BEN_CI18,284651696,201924978,28171934,82726718,173753044,17617892,1250511108,1174630426,75880682,233913209,940717217,531335982,416398696,114937286,280261230,136137466
Kaziranga,Kanha,Kaziranga-Kanha,BEN_NE2,BEN_CI19,212815865,140227510,12028286,72588355,128199224,12028286,1250511108,1174630426,75880682,233913209,940717217,370653731,261143653,109510078,241812071,19331582
Kaziranga,Kanha,Kaziranga-Kanha,BEN_NE2,BEN_CI3,346836050,262766534,84692352,84069516,178074182,27445318,1250511108,1174630426,75880682,233913209,940717217,399948004,398407865,1540139,114426239,283981626
Kaziranga,Kanha,Kaziranga-Kanha,BEN_NE2,BEN_CI4,335468856,269661789,96999887,65807067,172661902,34842750,1250511108,1174630426,75880682,233913209,940717217,588039664,506748544,81291120,270707157,236041387
Kaziranga,Kanha,Kaziranga-Kanha,BEN_NE2,BEN_CI5,263608465,203454823,37790989,60153642,165663834,25282326,1250511108,1174630426,75880682,233913209,940717217,447217937,358814659,88403278,289122614,69692045
Kaziranga,Kanha,Kaziranga-Kanha,BEN_NE2,BEN_CI6,324201515,250124014,70700839,74077501,179423175,34513420,1250511108,1174630426,75880682,233913209,940717217,558093435,456569955,101523480,304633087,151936868
Kaziranga,Kanha,Kaziranga-Kanha,BEN_NE2,BEN_CI7,403841621,368620074,197933628,35221547,170686446,59240430,1250511108,1174630426,75880682,233913209,940717217,746271387,730520258,15751129,197580294,532939964
Kaziranga,Kanha,Kaziranga-Kanha,BEN_NE3,BEN_CI15,268833225,198248033,41450450,70585192,156797583,23189721,1008859852,937520336,71339516,277485474,660034862,558426844,440368350,118058494,313676252,126692098
Kaziranga,Kanha,Kaziranga-Kanha,BEN_NE3,BEN_CI16,429063470,365173423,175555852,63890047,189617571,53858923,1008859852,937520336,71339516,277485474,660034862,941465693,865515372,75950321,260165870,605349502
Kaziranga,Kanha,Kaziranga-Kanha,BEN_NE3,BEN_CI18,248305854,177200210,39039015,71105644,138161195,26182315,1008859852,937520336,71339516,277485474,660034862,531335982,416398696,114937286,280261230,136137466
Kaziranga,Kanha,Kaziranga-Kanha,BEN_NE3,BEN_CI19,165154006,101930153,3635721,63223853,98294432,3635721,1008859852,937520336,71339516,277485474,660034862,370653731,261143653,109510078,241812071,19331582
Kaziranga,Kanha,Kaziranga-Kanha,BEN_NE3,BEN_CI3,279874934,206727886,71727834,73147048,135000052,26490234,1008859852,937520336,71339516,277485474,660034862,399948004,398407865,1540139,114426239,283981626
Kaziranga,Kanha,Kaziranga-Kanha,BEN_NE3,BEN_CI4,258639180,197650712,44259880,60988468,153390832,27829827,1008859852,937520336,71339516,277485474,660034862,588039664,506748544,81291120,270707157,236041387
Kaziranga,Kanha,Kaziranga-Kanha,BEN_NE3,BEN_CI5,187706072,129153300,15559697,58552772,113593603,11179980,1008859852,937520336,71339516,277485474,660034862,447217937,358814659,88403278,289122614,69692045
Kaziranga,Kanha,Kaziranga-Kanha,BEN_NE3,BEN_CI6,267483966,202701873,56254302,64782093,146447571,36713775,1008859852,937520336,71339516,277485474,660034862,558093435,456569955,101523480,304633087,151936868
Kaziranga,Kanha,Kaziranga-Kanha,BEN_NE3,BEN_CI7,320349383,287090262,126080569,33259121,161009693,44616669,1008859852,937520336,71339516,277485474,660034862,746271387,730520258,15751129,197580294,532939964
Kaziranga,Kaziranga,Kaziranga-Kaziranga,BEN_NE1,BEN_NE2,325988542,232027920,82425936,93960622,149601984,29970776,560246780,423100976,137145804,256700947,166400029,1250511108,1174630426,75880682,233913209,940717217
Kaziranga,Kaziranga,Kaziranga-Kaziranga,BEN_NE1,BEN_NE3,254609534,169715721,29301759,84893813,140413962,19023211,560246780,423100976,137145804,256700947,166400029,1008859852,937520336,71339516,277485474,660034862
Kaziranga,Kaziranga,Kaziranga-Kaziranga,BEN_NE2,BEN_NE1,325988542,232027920,82425936,93960622,149601984,29970776,1250511108,1174630426,75880682,233913209,940717217,560246780,423100976,137145804,256700947,166400029
Kaziranga,Kaziranga,Kaziranga-Kaziranga,BEN_NE2,BEN_NE3,546680479,469280877,233730760,77399602,235550117,93594093,1250511108,1174630426,75880682,233913209,940717217,1008859852,937520336,71339516,277485474,660034862
Kaziranga,Kaziranga,Kaziranga-Kaziranga,BEN_NE3,BEN_NE1,254609534,169715721,29301759,84893813,140413962,19023211,1008859852,937520336,71339516,277485474,660034862,560246780,423100976,137145804,256700947,166400029
Kaziranga,Kaziranga,Kaziranga-Kaziranga,BEN_NE3,BEN_NE2,546680479,469280877,233730760,77399602,235550117,93594093,1008859852,937520336,71339516,277485474,660034862,1250511108,1174630426,75880682,233913209,940717217
Kaziranga,Lalgarh,Kaziranga-Lalgarh,BEN_NE1,LGS1,178120386,104760415,5054692,73359971,99705723,5054692,560246780,423100976,137145804,256700947,166400029,737843728,638009894,99833834,404772144,233237750
Kaziranga,Lalgarh,Kaziranga-Lalgarh,BEN_NE2,LGS1,384440898,296352532,57323818,88088366,239028714,36843414,1250511108,1174630426,75880682,233913209,940717217,737843728,638009894,99833834,404772144,233237750
Kaziranga,Lalgarh,Kaziranga-Lalgarh,BEN_NE3,LGS1,330014742,254923217,62437265,75091525,192485952,33208732,1008859852,937520336,71339516,277485474,660034862,737843728,638009894,99833834,404772144,233237750
Kaziranga,Periyar,Kaziranga-Periyar,BEN_NE1,BEN_SI5,338260414,243201648,62819671,95058766,180381977,35683157,560246780,423100976,137145804,256700947,166400029,1343835283,1299687777,44147506,344660143,955027634
Kaziranga,Periyar,Kaziranga-Periyar,BEN_NE2,BEN_SI5,761921482,690558736,401287743,71362746,289270993,173092267,1250511108,1174630426,75880682,233913209,940717217,1343835283,1299687777,44147506,344660143,955027634
Kaziranga,Periyar,Kaziranga-Periyar,BEN_NE3,BEN_SI5,621515314,555821259,275415655,65694055,280405604,121563726,1008859852,937520336,71339516,277485474,660034862,1343835283,1299687777,44147506,344660143,955027634
Kaziranga,Ranthambore,Kaziranga-Ranthambore,BEN_NE1,BEN_NW10,308824152,218995950,48704459,89828202,170291491,27714390,560246780,423100976,137145804,256700947,166400029,1266198710,1229664069,36534641,328923565,900740504
Kaziranga,Ranthambore,Kaziranga-Ranthambore,BEN_NE1,BEN_NW11,248564776,174097232,37369527,74467544,136727705,11079563,560246780,423100976,137145804,256700947,166400029,997123987,950413379,46710608,263905963,686507416
Kaziranga,Ranthambore,Kaziranga-Ranthambore,BEN_NE1,BEN_NW12,321502401,236852160,70250724,84650241,166601436,30005778,560246780,423100976,137145804,256700947,166400029,1267506856,1231795407,35711449,227052846,1004742561
Kaziranga,Ranthambore,Kaziranga-Ranthambore,BEN_NE1,BEN_NW13,295564593,211276575,54265168,84288018,157011407,27747808,560246780,423100976,137145804,256700947,166400029,1183131254,1138285233,44846021,344174628,794110605
Kaziranga,Ranthambore,Kaziranga-Ranthambore,BEN_NE1,BEN_NW14,317937131,234872146,85917884,83064985,148954262,28949525,560246780,423100976,137145804,256700947,166400029,1235716540,1190952996,44763544,177541519,1013411477
Kaziranga,Ranthambore,Kaziranga-Ranthambore,BEN_NE1,BEN_NW17,279794656,201226870,55296008,78567786,145930862,25125119,560246780,423100976,137145804,256700947,166400029,1116321554,1085802823,30518731,256140006,829662817
Kaziranga,Ranthambore,Kaziranga-Ranthambore,BEN_NE1,BEN_NW18,332804437,242159616,72630974,90644821,169528642,34722130,560246780,423100976,137145804,256700947,166400029,1339364699,1300736006,38628693,242877521,1057858485
Kaziranga,Ranthambore,Kaziranga-Ranthambore,BEN_NE1,BEN_NW19,277734648,201158914,72637366,76575734,128521548,27635921,560246780,423100976,137145804,256700947,166400029,1081768306,1036331080,45437226,232322355,804008725
Kaziranga,Ranthambore,Kaziranga-Ranthambore,BEN_NE1,BEN_NW20,281470184,195816961,34110898,85653223,161706063,15699823,560246780,423100976,137145804,256700947,166400029,1086271749,1022278981,63992768,541693814,480585167
Kaziranga,Ranthambore,Kaziranga-Ranthambore,BEN_NE1,BEN_NW24,271530202,185979141,33878580,85551061,152100561,31656549,560246780,423100976,137145804,256700947,166400029,1159641386,1113494396,46146990,301627698,811866698
Kaziranga,Ranthambore,Kaziranga-Ranthambore,BEN_NE1,BEN_NW3,311632159,222385955,61730722,89246204,160655233,22494413,560246780,423100976,137145804,256700947,166400029,1280728709,1240123254,40605455,207797688,1032325566
Kaziranga,Ranthambore,Kaziranga-Ranthambore,BEN_NE1,BEN_NW4,306762303,228470633,85089524,78291670,143381109,30100703,560246780,423100976,137145804,256700947,166400029,1219365724,1186222475,33143249,158691252,1027531223
Kaziranga,Ranthambore,Kaziranga-Ranthambore,BEN_NE1,BEN_NW5,247193395,175933408,48519710,71259987,127413698,18752039,560246780,423100976,137145804,256700947,166400029,977809134,918585062,59224072,241966240,676618822
Kaziranga,Ranthambore,Kaziranga-Ranthambore,BEN_NE1,BEN_NW55,277517373,190912444,35241655,86604929,155670789,22643276,560246780,423100976,137145804,256700947,166400029,1131174741,1073214798,57959943,534097691,539117107
Kaziranga,Ranthambore,Kaziranga-Ranthambore,BEN_NE1,BEN_NW57,304952525,206758594,40068231,98193931,166690363,27764367,560246780,423100976,137145804,256700947,166400029,1180288036,1103120235,77167801,638361097,464759138
Kaziranga,Ranthambore,Kaziranga-Ranthambore,BEN_NE1,BEN_NW6,251055609,175980460,43874951,75075149,132105509,22958884,560246780,423100976,137145804,256700947,166400029,992143483,946435718,45707765,248527765,697907953
Kaziranga,Ranthambore,Kaziranga-Ranthambore,BEN_NE1,BEN_NW8,305074413,221318390,65797102,83756023,155521288,23448888,560246780,423100976,137145804,256700947,166400029,1196839698,1156984240,39855458,275076038,881908202
Kaziranga,Ranthambore,Kaziranga-Ranthambore,BEN_NE1,BEN_NW9,315683760,231306540,74715098,84377220,156591442,23034631,560246780,423100976,137145804,256700947,166400029,1246521228,1203200533,43320695,216389572,986810961
Kaziranga,Ranthambore,Kaziranga-Ranthambore,BEN_NE2,BEN_NW10,690935769,622420812,342724869,68514957,279695943,162942701,1250511108,1174630426,75880682,233913209,940717217,1266198710,1229664069,36534641,328923565,900740504
Kaziranga,Ranthambore,Kaziranga-Ranthambore,BEN_NE2,BEN_NW11,558281397,497148769,271430335,61132628,225718434,119144494,1250511108,1174630426,75880682,233913209,940717217,997123987,950413379,46710608,263905963,686507416
Kaziranga,Ranthambore,Kaziranga-Ranthambore,BEN_NE2,BEN_NW12,685722706,620259676,374370887,65463030,245888789,118970795,1250511108,1174630426,75880682,233913209,940717217,1267506856,1231795407,35711449,227052846,1004742561
Kaziranga,Ranthambore,Kaziranga-Ranthambore,BEN_NE2,BEN_NW13,632932416,561236695,285961190,71695721,275275505,133751426,1250511108,1174630426,75880682,233913209,940717217,1183131254,1138285233,44846021,344174628,794110605
Kaziranga,Ranthambore,Kaziranga-Ranthambore,BEN_NE2,BEN_NW14,691782074,621610873,409747236,70171201,211863637,122405961,1250511108,1174630426,75880682,233913209,940717217,1235716540,1190952996,44763544,177541519,1013411477
Kaziranga,Ranthambore,Kaziranga-Ranthambore,BEN_NE2,BEN_NW17,635800265,578095991,343436593,57704274,234659398,122657429,1250511108,1174630426,75880682,233913209,940717217,1116321554,1085802823,30518731,256140006,829662817
Kaziranga,Ranthambore,Kaziranga-Ranthambore,BEN_NE2,BEN_NW18,769563816,706763014,464666954,62800802,242096060,149182189,1250511108,1174630426,75880682,233913209,940717217,1339364699,1300736006,38628693,242877521,1057858485
Kaziranga,Ranthambore,Kaziranga-Ranthambore,BEN_NE2,BEN_NW19,567476209,499897748,284434749,67578461,215462999,80498039,1250511108,1174630426,75880682,233913209,940717217,1081768306,1036331080,45437226,232322355,804008725
Kaziranga,Ranthambore,Kaziranga-Ranthambore,BEN_NE2,BEN_NW20,575212439,498930400,146532008,76282039,352398392,113424419,1250511108,1174630426,75880682,233913209,940717217,1086271749,1022278981,63992768,541693814,480585167
Kaziranga,Ranthambore,Kaziranga-Ranthambore,BEN_NE2,BEN_NW24,651135574,583837967,329703509,67297607,254134458,160676175,1250511108,1174630426,75880682,233913209,940717217,1159641386,1113494396,46146990,301627698,811866698
Kaziranga,Ranthambore,Kaziranga-Ranthambore,BEN_NE2,BEN_NW3,701662777,634474451,415324758,67188326,219149693,102153742,1250511108,1174630426,75880682,233913209,940717217,1280728709,1240123254,40605455,207797688,1032325566
Kaziranga,Ranthambore,Kaziranga-Ranthambore,BEN_NE2,BEN_NW4,649958236,588939198,390895691,61019038,198043507,94083506,1250511108,1174630426,75880682,233913209,940717217,1219365724,1186222475,33143249,158691252,1027531223
Kaziranga,Ranthambore,Kaziranga-Ranthambore,BEN_NE2,BEN_NW5,531062560,465549618,256254227,65512942,209295391,108502266,1250511108,1174630426,75880682,233913209,940717217,977809134,918585062,59224072,241966240,676618822
Kaziranga,Ranthambore,Kaziranga-Ranthambore,BEN_NE2,BEN_NW55,601103016,522289195,199828709,78813821,322460486,119629599,1250511108,1174630426,75880682,233913209,940717217,1131174741,1073214798,57959943,534097691,539117107
Kaziranga,Ranthambore,Kaziranga-Ranthambore,BEN_NE2,BEN_NW57,694961084,610573888,212609433,84387196,397964455,137291093,1250511108,1174630426,75880682,233913209,940717217,1180288036,1103120235,77167801,638361097,464759138
Kaziranga,Ranthambore,Kaziranga-Ranthambore,BEN_NE2,BEN_NW6,535326399,471992448,258716320,63333951,213276128,109330689,1250511108,1174630426,75880682,233913209,940717217,992143483,946435718,45707765,248527765,697907953
Kaziranga,Ranthambore,Kaziranga-Ranthambore,BEN_NE2,BEN_NW8,659115193,595171586,332545288,63943607,262626298,121314601,1250511108,1174630426,75880682,233913209,940717217,1196839698,1156984240,39855458,275076038,881908202
Kaziranga,Ranthambore,Kaziranga-Ranthambore,BEN_NE2,BEN_NW9,653448297,581968228,354794085,71480069,227174143,101341573,1250511108,1174630426,75880682,233913209,940717217,1246521228,1203200533,43320695,216389572,986810961
Kaziranga,Ranthambore,Kaziranga-Ranthambore,BEN_NE3,BEN_NW10,579035566,519428626,279134658,59606940,240293968,146289124,1008859852,937520336,71339516,277485474,660034862,1266198710,1229664069,36534641,328923565,900740504
Kaziranga,Ranthambore,Kaziranga-Ranthambore,BEN_NE3,BEN_NW11,461916200,408373983,199624625,53542217,208749358,101135680,1008859852,937520336,71339516,277485474,660034862,997123987,950413379,46710608,263905963,686507416
Kaziranga,Ranthambore,Kaziranga-Ranthambore,BEN_NE3,BEN_NW12,578582186,523685950,292420584,54896236,231265366,116148259,1008859852,937520336,71339516,277485474,660034862,1267506856,1231795407,35711449,227052846,1004742561
Kaziranga,Ranthambore,Kaziranga-Ranthambore,BEN_NE3,BEN_NW13,532101830,470524285,218930527,61577545,251593758,120706042,1008859852,937520336,71339516,277485474,660034862,1183131254,1138285233,44846021,344174628,794110605
Kaziranga,Ranthambore,Kaziranga-Ranthambore,BEN_NE3,BEN_NW14,574814717,513850651,307698490,60964066,206152161,107343245,1008859852,937520336,71339516,277485474,660034862,1235716540,1190952996,44763544,177541519,1013411477
Kaziranga,Ranthambore,Kaziranga-Ranthambore,BEN_NE3,BEN_NW17,531670700,481201769,287288161,50468931,193913608,107555909,1008859852,937520336,71339516,277485474,660034862,1116321554,1085802823,30518731,256140006,829662817
Kaziranga,Ranthambore,Kaziranga-Ranthambore,BEN_NE3,BEN_NW18,609219580,548328153,308586514,60891427,239741639,128375475,1008859852,937520336,71339516,277485474,660034862,1339364699,1300736006,38628693,242877521,1057858485
Kaziranga,Ranthambore,Kaziranga-Ranthambore,BEN_NE3,BEN_NW19,488947825,429053745,233842154,59894080,195211591,102504522,1008859852,937520336,71339516,277485474,660034862,1081768306,1036331080,45437226,232322355,804008725
Kaziranga,Ranthambore,Kaziranga-Ranthambore,BEN_NE3,BEN_NW20,476749826,409761325,121446727,66988501,288314598,92901301,1008859852,937520336,71339516,277485474,660034862,1086271749,1022278981,63992768,541693814,480585167
Kaziranga,Ranthambore,Kaziranga-Ranthambore,BEN_NE3,BEN_NW24,529095209,467750547,212319426,61344662,255431121,132283491,1008859852,937520336,71339516,277485474,660034862,1159641386,1113494396,46146990,301627698,811866698
Kaziranga,Ranthambore,Kaziranga-Ranthambore,BEN_NE3,BEN_NW3,593674616,533644501,313846676,60030115,219797825,94636415,1008859852,937520336,71339516,277485474,660034862,1280728709,1240123254,40605455,207797688,1032325566
Kaziranga,Ranthambore,Kaziranga-Ranthambore,BEN_NE3,BEN_NW4,508762173,451377183,256084298,57384990,195292885,94900731,1008859852,937520336,71339516,277485474,660034862,1219365724,1186222475,33143249,158691252,1027531223
Kaziranga,Ranthambore,Kaziranga-Ranthambore,BEN_NE3,BEN_NW5,450931192,390188172,199957778,60743020,190230394,87179331,1008859852,937520336,71339516,277485474,660034862,977809134,918585062,59224072,241966240,676618822
Kaziranga,Ranthambore,Kaziranga-Ranthambore,BEN_NE3,BEN_NW55,509072138,440130477,144524725,68941661,295605752,92287529,1008859852,937520336,71339516,277485474,660034862,1131174741,1073214798,57959943,534097691,539117107
Kaziranga,Ranthambore,Kaziranga-Ranthambore,BEN_NE3,BEN_NW57,540582507,463190588,131564119,77391919,331626469,84632428,1008859852,937520336,71339516,277485474,660034862,1180288036,1103120235,77167801,638361097,464759138
Kaziranga,Ranthambore,Kaziranga-Ranthambore,BEN_NE3,BEN_NW6,457093927,402588389,216240014,54505538,186348375,100472554,1008859852,937520336,71339516,277485474,660034862,992143483,946435718,45707765,248527765,697907953
Kaziranga,Ranthambore,Kaziranga-Ranthambore,BEN_NE3,BEN_NW8,535398639,477296649,242582185,58101990,234714464,125293224,1008859852,937520336,71339516,277485474,660034862,1196839698,1156984240,39855458,275076038,881908202
Kaziranga,Ranthambore,Kaziranga-Ranthambore,BEN_NE3,BEN_NW9,549435240,486365356,254955513,63069884,231409843,98483305,1008859852,937520336,71339516,277485474,660034862,1246521228,1203200533,43320695,216389572,986810961
Kaziranga,Wayanad,Kaziranga-Wayanad,BEN_NE1,BEN_SI1,222973773,145381126,13968118,77592647,131413008,9265503,560246780,423100976,137145804,256700947,166400029,897358653,799698739,97659914,345341326,454357413
Kaziranga,Wayanad,Kaziranga-Wayanad,BEN_NE1,BEN_SI11,145287576,99362472,9202203,45925104,90160269,6651825,560246780,423100976,137145804,256700947,166400029,641166204,612648765,28517439,241001807,371646958
Kaziranga,Wayanad,Kaziranga-Wayanad,BEN_NE1,BEN_SI2,153951848,112494096,21418629,41457752,91075467,14219868,560246780,423100976,137145804,256700947,166400029,650993225,648515374,2477851,140667619,507847755
Kaziranga,Wayanad,Kaziranga-Wayanad,BEN_NE1,BEN_SI3,213120166,135957881,16274492,77162285,119683389,14169066,560246780,423100976,137145804,256700947,166400029,931565359,847325564,84239795,345974583,501350981
Kaziranga,Wayanad,Kaziranga-Wayanad,BEN_NE1,BEN_SI4,282017259,199958164,62813553,82059095,137144611,27744502,560246780,423100976,137145804,256700947,166400029,1109312253,1030580255,78731998,302255092,728325163
Kaziranga,Wayanad,Kaziranga-Wayanad,BEN_NE1,BEN_SI6,229846758,150810824,18781444,79035934,132029380,10806672,560246780,423100976,137145804,256700947,166400029,951080464,864453508,86626956,319674486,544779022
Kaziranga,Wayanad,Kaziranga-Wayanad,BEN_NE1,BEN_SI7,215206145,136443937,19421778,78762208,117022159,15218702,560246780,423100976,137145804,256700947,166400029,942430262,853584663,88845599,335397181,518187482
Kaziranga,Wayanad,Kaziranga-Wayanad,BEN_NE1,BEN_SI8,280869981,198925137,62982231,81944844,135942906,23127840,560246780,423100976,137145804,256700947,166400029,1108177315,1029030472,79146843,300308119,728722353
Kaziranga,Wayanad,Kaziranga-Wayanad,BEN_NE1,BEN_SI9,209478822,135025248,23382893,74453574,111642355,12991738,560246780,423100976,137145804,256700947,166400029,849233213,745820153,103413060,339499389,406320764
Kaziranga,Wayanad,Kaziranga-Wayanad,BEN_NE2,BEN_SI1,481104062,394948761,165264882,86155301,229683879,57352864,1250511108,1174630426,75880682,233913209,940717217,897358653,799698739,97659914,345341326,454357413
Kaziranga,Wayanad,Kaziranga-Wayanad,BEN_NE2,BEN_SI11,382119563,345144246,170873601,36975317,174270645,81084539,1250511108,1174630426,75880682,233913209,940717217,641166204,612648765,28517439,241001807,371646958
Kaziranga,Wayanad,Kaziranga-Wayanad,BEN_NE2,BEN_SI2,352832932,327979779,204631204,24853153,123348575,54812076,1250511108,1174630426,75880682,233913209,940717217,650993225,648515374,2477851,140667619,507847755
Kaziranga,Wayanad,Kaziranga-Wayanad,BEN_NE2,BEN_SI3,545079927,468596044,248194584,76483883,220401460,84793702,1250511108,1174630426,75880682,233913209,940717217,931565359,847325564,84239795,345974583,501350981
Kaziranga,Wayanad,Kaziranga-Wayanad,BEN_NE2,BEN_SI4,634940889,555173202,325352171,79767687,229821031,87715177,1250511108,1174630426,75880682,233913209,940717217,1109312253,1030580255,78731998,302255092,728325163
Kaziranga,Wayanad,Kaziranga-Wayanad,BEN_NE2,BEN_SI6,539600917,459772466,246296911,79828451,213475555,87852627,1250511108,1174630426,75880682,233913209,940717217,951080464,864453508,86626956,319674486,544779022
Kaziranga,Wayanad,Kaziranga-Wayanad,BEN_NE2,BEN_SI7,551643555,472966714,260931216,78676841,212035498,70781149,1250511108,1174630426,75880682,233913209,940717217,942430262,853584663,88845599,335397181,518187482
Kaziranga,Wayanad,Kaziranga-Wayanad,BEN_NE2,BEN_SI8,634720459,554425770,325966867,80294689,228458903,79746264,1250511108,1174630426,75880682,233913209,940717217,1108177315,1029030472,79146843,300308119,728722353
Kaziranga,Wayanad,Kaziranga-Wayanad,BEN_NE2,BEN_SI9,461953829,375411786,159413941,86542043,215997845,64479401,1250511108,1174630426,75880682,233913209,940717217,849233213,745820153,103413060,339499389,406320764
Kaziranga,Wayanad,Kaziranga-Wayanad,BEN_NE3,BEN_SI1,418339140,343951307,149775094,74387833,194176213,60462920,1008859852,937520336,71339516,277485474,660034862,897358653,799698739,97659914,345341326,454357413
Kaziranga,Wayanad,Kaziranga-Wayanad,BEN_NE3,BEN_SI11,264205890,226432447,72890303,37773443,153542144,47842894,1008859852,937520336,71339516,277485474,660034862,641166204,612648765,28517439,241001807,371646958
Kaziranga,Wayanad,Kaziranga-Wayanad,BEN_NE3,BEN_SI2,296866822,273426938,144528280,23439884,128898658,61343066,1008859852,937520336,71339516,277485474,660034862,650993225,648515374,2477851,140667619,507847755
Kaziranga,Wayanad,Kaziranga-Wayanad,BEN_NE3,BEN_SI3,432443089,364570912,165832716,67872177,198738196,75021596,1008859852,937520336,71339516,277485474,660034862,931565359,847325564,84239795,345974583,501350981
Kaziranga,Wayanad,Kaziranga-Wayanad,BEN_NE3,BEN_SI4,485484846,412429892,195785044,73054954,216644848,65299940,1008859852,937520336,71339516,277485474,660034862,1109312253,1030580255,78731998,302255092,728325163
Kaziranga,Wayanad,Kaziranga-Wayanad,BEN_NE3,BEN_SI6,409079947,332917074,115861590,76162873,217055484,64035428,1008859852,937520336,71339516,277485474,660034862,951080464,864453508,86626956,319674486,544779022
Kaziranga,Wayanad,Kaziranga-Wayanad,BEN_NE3,BEN_SI7,437185719,365071186,167201165,72114533,197870021,82652422,1008859852,937520336,71339516,277485474,660034862,942430262,853584663,88845599,335397181,518187482
Kaziranga,Wayanad,Kaziranga-Wayanad,BEN_NE3,BEN_SI8,486348741,412136620,198584084,74212121,213552536,69912309,1008859852,937520336,71339516,277485474,660034862,1108177315,1029030472,79146843,300308119,728722353
Kaziranga,Wayanad,Kaziranga-Wayanad,BEN_NE3,BEN_SI9,404317129,329245391,135015981,75071738,194229410,63788616,1008859852,937520336,71339516,277485474,660034862,849233213,745820153,103413060,339499389,406320764
Kaziranga,Zoo,Kaziranga-Zoo,BEN_NE1,ZSB_01,177962119,115620362,15746024,62341757,99874338,10115018,560246780,423100976,137145804,256700947,166400029,723092447,635855373,87237074,256023333,379832040
Kaziranga,Zoo,Kaziranga-Zoo,BEN_NE1,ZSB_02,256932088,185850957,61349773,71081131,124501184,28221563,560246780,423100976,137145804,256700947,166400029,942790346,865053483,77736863,260820720,604232763
Kaziranga,Zoo,Kaziranga-Zoo,BEN_NE1,ZSB_03,238313600,172507706,50376612,65805894,122131094,15693086,560246780,423100976,137145804,256700947,166400029,892317758,827799945,64517813,241409256,586390689
Kaziranga,Zoo,Kaziranga-Zoo,BEN_NE1,ZSB_04,225364490,160484919,34430708,64879571,126054211,14144084,560246780,423100976,137145804,256700947,166400029,867386629,799476794,67909835,302302125,497174669
Kaziranga,Zoo,Kaziranga-Zoo,BEN_NE1,ZSB_05,214707605,145293908,30603600,69413697,114690308,9663401,560246780,423100976,137145804,256700947,166400029,864922054,784467789,80454265,246263826,538203963
Kaziranga,Zoo,Kaziranga-Zoo,BEN_NE2,ZSB_01,364799917,287568618,94488789,77231299,193079829,42580795,1250511108,1174630426,75880682,233913209,940717217,723092447,635855373,87237074,256023333,379832040
Kaziranga,Zoo,Kaziranga-Zoo,BEN_NE2,ZSB_02,497771873,421676706,208603007,76095167,213073699,93180742,1250511108,1174630426,75880682,233913209,940717217,942790346,865053483,77736863,260820720,604232763
Kaziranga,Zoo,Kaziranga-Zoo,BEN_NE2,ZSB_03,477666491,410755707,209124687,66910784,201631020,90772742,1250511108,1174630426,75880682,233913209,940717217,892317758,827799945,64517813,241409256,586390689
Kaziranga,Zoo,Kaziranga-Zoo,BEN_NE2,ZSB_04,468753030,402885743,179523241,65867287,223362502,87658298,1250511108,1174630426,75880682,233913209,940717217,867386629,799476794,67909835,302302125,497174669
Kaziranga,Zoo,Kaziranga-Zoo,BEN_NE2,ZSB_05,452805499,374577856,181022184,78227643,193555672,62831812,1250511108,1174630426,75880682,233913209,940717217,864922054,784467789,80454265,246263826,538203963
Kaziranga,Zoo,Kaziranga-Zoo,BEN_NE3,ZSB_01,331920232,268610328,103646769,63309904,164963559,41137884,1008859852,937520336,71339516,277485474,660034862,723092447,635855373,87237074,256023333,379832040
Kaziranga,Zoo,Kaziranga-Zoo,BEN_NE3,ZSB_02,404474843,336323102,155603737,68151741,180719365,54565491,1008859852,937520336,71339516,277485474,660034862,942790346,865053483,77736863,260820720,604232763
Kaziranga,Zoo,Kaziranga-Zoo,BEN_NE3,ZSB_03,418963561,358482394,176530452,60481167,181951942,67413056,1008859852,937520336,71339516,277485474,660034862,892317758,827799945,64517813,241409256,586390689
Kaziranga,Zoo,Kaziranga-Zoo,BEN_NE3,ZSB_04,378578337,317202906,127006137,61375431,190196769,61196786,1008859852,937520336,71339516,277485474,660034862,867386629,799476794,67909835,302302125,497174669
Kaziranga,Zoo,Kaziranga-Zoo,BEN_NE3,ZSB_05,384656823,318709167,153422440,65947656,165286727,51763701,1008859852,937520336,71339516,277485474,660034862,864922054,784467789,80454265,246263826,538203963
Lalgarh,Chandrapur,Lalgarh-Chandrapur,LGS1,BEN_CI2,234234546,198844273,39200816,35390273,159643457,19929922,737843728,638009894,99833834,404772144,233237750,674364895,657438378,16926517,229909737,427528641
Lalgarh,Corbett,Lalgarh-Corbett,LGS1,BEN_NOR1,222547604,152180749,10922112,70366855,141258637,10922112,737843728,638009894,99833834,404772144,233237750,689133358,592060124,97073234,396388890,195671234
Lalgarh,Corbett,Lalgarh-Corbett,LGS1,BEN_NOR2,294079062,219971396,40825717,74107666,179145679,33116008,737843728,638009894,99833834,404772144,233237750,872604239,770086648,102517591,315997124,454089524
Lalgarh,Kanha,Lalgarh-Kanha,LGS1,BEN_CI15,186039447,117481542,8452956,68557905,109028586,6336653,737843728,638009894,99833834,404772144,233237750,558426844,440368350,118058494,313676252,126692098
Lalgarh,Kanha,Lalgarh-Kanha,LGS1,BEN_CI16,301581306,235143170,61825480,66438136,173317690,43323236,737843728,638009894,99833834,404772144,233237750,941465693,865515372,75950321,260165870,605349502
Lalgarh,Kanha,Lalgarh-Kanha,LGS1,BEN_CI18,176174703,108283728,10349244,67890975,97934484,10349244,737843728,638009894,99833834,404772144,233237750,531335982,416398696,114937286,280261230,136137466
Lalgarh,Kanha,Lalgarh-Kanha,LGS1,BEN_CI19,123241582,67120116,,56121466,67120116,,737843728,638009894,99833834,404772144,233237750,370653731,261143653,109510078,241812071,19331582
Lalgarh,Kanha,Lalgarh-Kanha,LGS1,BEN_CI3,192523125,122351697,6880669,70171428,115471028,6880669,737843728,638009894,99833834,404772144,233237750,399948004,398407865,1540139,114426239,283981626
Lalgarh,Kanha,Lalgarh-Kanha,LGS1,BEN_CI4,195009763,138420694,21366495,56589069,117054199,11739414,737843728,638009894,99833834,404772144,233237750,588039664,506748544,81291120,270707157,236041387
Lalgarh,Kanha,Lalgarh-Kanha,LGS1,BEN_CI5,164510269,112055259,5267388,52455010,106787871,2476514,737843728,638009894,99833834,404772144,233237750,447217937,358814659,88403278,289122614,69692045
Lalgarh,Kanha,Lalgarh-Kanha,LGS1,BEN_CI6,196802490,133328908,23781976,63473582,109546932,15837706,737843728,638009894,99833834,404772144,233237750,558093435,456569955,101523480,304633087,151936868
Lalgarh,Kanha,Lalgarh-Kanha,LGS1,BEN_CI7,213516752,175417757,28280246,38098995,147137511,17375521,737843728,638009894,99833834,404772144,233237750,746271387,730520258,15751129,197580294,532939964
Lalgarh,Kaziranga,Lalgarh-Kaziranga,LGS1,BEN_NE1,178120386,104760415,5054692,73359971,99705723,5054692,737843728,638009894,99833834,404772144,233237750,560246780,423100976,137145804,256700947,166400029
Lalgarh,Kaziranga,Lalgarh-Kaziranga,LGS1,BEN_NE2,384440898,296352532,57323818,88088366,239028714,36843414,737843728,638009894,99833834,404772144,233237750,1250511108,1174630426,75880682,233913209,940717217
Lalgarh,Kaziranga,Lalgarh-Kaziranga,LGS1,BEN_NE3,330014742,254923217,62437265,75091525,192485952,33208732,737843728,638009894,99833834,404772144,233237750,1008859852,937520336,71339516,277485474,660034862
Lalgarh,Periyar,Lalgarh-Periyar,LGS1,BEN_SI5,420997788,339864370,75401775,81133418,264462595,52560105,737843728,638009894,99833834,404772144,233237750,1343835283,1299687777,44147506,344660143,955027634
Lalgarh,Ranthambore,Lalgarh-Ranthambore,LGS1,BEN_NW10,433235486,364283968,104336668,68951518,259947300,72646335,737843728,638009894,99833834,404772144,233237750,1266198710,1229664069,36534641,328923565,900740504
Lalgarh,Ranthambore,Lalgarh-Ranthambore,LGS1,BEN_NW11,321408920,257123429,79078130,64285491,178045299,48535731,737843728,638009894,99833834,404772144,233237750,997123987,950413379,46710608,263905963,686507416
Lalgarh,Ranthambore,Lalgarh-Ranthambore,LGS1,BEN_NW12,421408790,354124340,102684973,67284450,251439367,66245620,737843728,638009894,99833834,404772144,233237750,1267506856,1231795407,35711449,227052846,1004742561
Lalgarh,Ranthambore,Lalgarh-Ranthambore,LGS1,BEN_NW13,414315480,347460353,91137120,66855127,256323233,59518446,737843728,638009894,99833834,404772144,233237750,1183131254,1138285233,44846021,344174628,794110605
Lalgarh,Ranthambore,Lalgarh-Ranthambore,LGS1,BEN_NW14,404420479,333912357,91666619,70508122,242245738,58498619,737843728,638009894,99833834,404772144,233237750,1235716540,1190952996,44763544,177541519,1013411477
Lalgarh,Ranthambore,Lalgarh-Ranthambore,LGS1,BEN_NW17,366941381,304490183,75285852,62451198,229204331,50627112,737843728,638009894,99833834,404772144,233237750,1116321554,1085802823,30518731,256140006,829662817
Lalgarh,Ranthambore,Lalgarh-Ranthambore,LGS1,BEN_NW18,440567835,369843960,105653339,70723875,264190621,70947784,737843728,638009894,99833834,404772144,233237750,1339364699,1300736006,38628693,242877521,1057858485
Lalgarh,Ranthambore,Lalgarh-Ranthambore,LGS1,BEN_NW19,354442167,288431409,64510618,66010758,223920791,50998700,737843728,638009894,99833834,404772144,233237750,1081768306,1036331080,45437226,232322355,804008725
Lalgarh,Ranthambore,Lalgarh-Ranthambore,LGS1,BEN_NW20,384582732,315673649,81163299,68909083,234510350,48643028,737843728,638009894,99833834,404772144,233237750,1086271749,1022278981,63992768,541693814,480585167
Lalgarh,Ranthambore,Lalgarh-Ranthambore,LGS1,BEN_NW24,402226672,331230851,85089546,70995821,246141305,55224835,737843728,638009894,99833834,404772144,233237750,1159641386,1113494396,46146990,301627698,811866698
Lalgarh,Ranthambore,Lalgarh-Ranthambore,LGS1,BEN_NW3,423830678,351140983,113215225,72689695,237925758,67127098,737843728,638009894,99833834,404772144,233237750,1280728709,1240123254,40605455,207797688,1032325566
Lalgarh,Ranthambore,Lalgarh-Ranthambore,LGS1,BEN_NW4,407852936,346489254,104843516,61363682,241645738,57394869,737843728,638009894,99833834,404772144,233237750,1219365724,1186222475,33143249,158691252,1027531223
Lalgarh,Ranthambore,Lalgarh-Ranthambore,LGS1,BEN_NW5,312415268,245190689,52845792,67224579,192344897,31982866,737843728,638009894,99833834,404772144,233237750,977809134,918585062,59224072,241966240,676618822
Lalgarh,Ranthambore,Lalgarh-Ranthambore,LGS1,BEN_NW55,395168847,325222321,74430822,69946526,250791499,40895264,737843728,638009894,99833834,404772144,233237750,1131174741,1073214798,57959943,534097691,539117107
Lalgarh,Ranthambore,Lalgarh-Ranthambore,LGS1,BEN_NW57,389959788,310346723,68536980,79613065,241809743,47038753,737843728,638009894,99833834,404772144,233237750,1180288036,1103120235,77167801,638361097,464759138
Lalgarh,Ranthambore,Lalgarh-Ranthambore,LGS1,BEN_NW6,329208673,270644216,66821443,58564457,203822773,39831943,737843728,638009894,99833834,404772144,233237750,992143483,946435718,45707765,248527765,697907953
Lalgarh,Ranthambore,Lalgarh-Ranthambore,LGS1,BEN_NW8,375524078,307232565,72378406,68291513,234854159,42055417,737843728,638009894,99833834,404772144,233237750,1196839698,1156984240,39855458,275076038,881908202
Lalgarh,Ranthambore,Lalgarh-Ranthambore,LGS1,BEN_NW9,415353417,346145527,99893127,69207890,246252400,62528899,737843728,638009894,99833834,404772144,233237750,1246521228,1203200533,43320695,216389572,986810961
Lalgarh,Wayanad,Lalgarh-Wayanad,LGS1,BEN_SI1,310323171,234519616,46005117,75803555,188514499,29556074,737843728,638009894,99833834,404772144,233237750,897358653,799698739,97659914,345341326,454357413
Lalgarh,Wayanad,Lalgarh-Wayanad,LGS1,BEN_SI11,212000915,168923643,36521061,43077272,132402582,26337246,737843728,638009894,99833834,404772144,233237750,641166204,612648765,28517439,241001807,371646958
Lalgarh,Wayanad,Lalgarh-Wayanad,LGS1,BEN_SI2,204302014,171643491,39253937,32658523,132389554,20089705,737843728,638009894,99833834,404772144,233237750,650993225,648515374,2477851,140667619,507847755
Lalgarh,Wayanad,Lalgarh-Wayanad,LGS1,BEN_SI3,310712542,236855140,57438289,73857402,179416851,26436598,737843728,638009894,99833834,404772144,233237750,931565359,847325564,84239795,345974583,501350981
Lalgarh,Wayanad,Lalgarh-Wayanad,LGS1,BEN_SI4,370442939,292441962,62175599,78000977,230266363,42621777,737843728,638009894,99833834,404772144,233237750,1109312253,1030580255,78731998,302255092,728325163
Lalgarh,Wayanad,Lalgarh-Wayanad,LGS1,BEN_SI6,322312550,249491820,58264396,72820730,191227424,38991102,737843728,638009894,99833834,404772144,233237750,951080464,864453508,86626956,319674486,544779022
Lalgarh,Wayanad,Lalgarh-Wayanad,LGS1,BEN_SI7,313839554,239355638,53551062,74483916,185804576,26441518,737843728,638009894,99833834,404772144,233237750,942430262,853584663,88845599,335397181,518187482
Lalgarh,Wayanad,Lalgarh-Wayanad,LGS1,BEN_SI8,369993959,291935595,65704185,78058364,226231410,52086043,737843728,638009894,99833834,404772144,233237750,1108177315,1029030472,79146843,300308119,728722353
Lalgarh,Wayanad,Lalgarh-Wayanad,LGS1,BEN_SI9,267473038,191154683,19041032,76318355,172113651,13769232,737843728,638009894,99833834,404772144,233237750,849233213,745820153,103413060,339499389,406320764
Lalgarh,Zoo,Lalgarh-Zoo,LGS1,ZSB_01,247261897,183945363,43973601,63316534,139971762,25247778,737843728,638009894,99833834,404772144,233237750,723092447,635855373,87237074,256023333,379832040
Lalgarh,Zoo,Lalgarh-Zoo,LGS1,ZSB_02,321148231,253580883,77043523,67567348,176537360,46025622,737843728,638009894,99833834,404772144,233237750,942790346,865053483,77736863,260820720,604232763
Lalgarh,Zoo,Lalgarh-Zoo,LGS1,ZSB_03,307975647,244304664,71717419,63670983,172587245,38971003,737843728,638009894,99833834,404772144,233237750,892317758,827799945,64517813,241409256,586390689
Lalgarh,Zoo,Lalgarh-Zoo,LGS1,ZSB_04,301129209,240976160,70069811,60153049,170906349,41281496,737843728,638009894,99833834,404772144,233237750,867386629,799476794,67909835,302302125,497174669
Lalgarh,Zoo,Lalgarh-Zoo,LGS1,ZSB_05,299134961,232636956,61169155,66498005,171467801,29592717,737843728,638009894,99833834,404772144,233237750,864922054,784467789,80454265,246263826,538203963
Periyar,Chandrapur,Periyar-Chandrapur,BEN_SI5,BEN_CI2,384029727,357109290,128427356,26920437,228681934,66735678,1343835283,1299687777,44147506,344660143,955027634,674364895,657438378,16926517,229909737,427528641
Periyar,Corbett,Periyar-Corbett,BEN_SI5,BEN_NOR1,404295795,331597242,69207018,72698553,262390224,58483729,1343835283,1299687777,44147506,344660143,955027634,689133358,592060124,97073234,396388890,195671234
Periyar,Corbett,Periyar-Corbett,BEN_SI5,BEN_NOR2,506943188,422962678,149626748,83980510,273335930,93376252,1343835283,1299687777,44147506,344660143,955027634,872604239,770086648,102517591,315997124,454089524
Periyar,Kanha,Periyar-Kanha,BEN_SI5,BEN_CI15,329271930,244047391,37635841,85224539,206411550,24664304,1343835283,1299687777,44147506,344660143,955027634,558426844,440368350,118058494,313676252,126692098
Periyar,Kanha,Periyar-Kanha,BEN_SI5,BEN_CI16,576666138,516883689,274318842,59782449,242564847,109045522,1343835283,1299687777,44147506,344660143,955027634,941465693,865515372,75950321,260165870,605349502
Periyar,Kanha,Periyar-Kanha,BEN_SI5,BEN_CI18,331357269,250023679,56992428,81333590,193031251,30357260,1343835283,1299687777,44147506,344660143,955027634,531335982,416398696,114937286,280261230,136137466
Periyar,Kanha,Periyar-Kanha,BEN_SI5,BEN_CI19,236431413,159809292,10623095,76622121,149186197,10623095,1343835283,1299687777,44147506,344660143,955027634,370653731,261143653,109510078,241812071,19331582
Periyar,Kanha,Periyar-Kanha,BEN_SI5,BEN_CI3,372673265,293898628,79067468,78774637,214831160,40859063,1343835283,1299687777,44147506,344660143,955027634,399948004,398407865,1540139,114426239,283981626
Periyar,Kanha,Periyar-Kanha,BEN_SI5,BEN_CI4,361569242,298844317,98195163,62724925,200649154,44822067,1343835283,1299687777,44147506,344660143,955027634,588039664,506748544,81291120,270707157,236041387
Periyar,Kanha,Periyar-Kanha,BEN_SI5,BEN_CI5,273854934,213145561,27379800,60709373,185765761,18160895,1343835283,1299687777,44147506,344660143,955027634,447217937,358814659,88403278,289122614,69692045
Periyar,Kanha,Periyar-Kanha,BEN_SI5,BEN_CI6,334885819,264369160,56427066,70516659,207942094,26061074,1343835283,1299687777,44147506,344660143,955027634,558093435,456569955,101523480,304633087,151936868
Periyar,Kanha,Periyar-Kanha,BEN_SI5,BEN_CI7,463012232,440579128,227879259,22433104,212699869,96016814,1343835283,1299687777,44147506,344660143,955027634,746271387,730520258,15751129,197580294,532939964
Periyar,Kaziranga,Periyar-Kaziranga,BEN_SI5,BEN_NE1,338260414,243201648,62819671,95058766,180381977,35683157,1343835283,1299687777,44147506,344660143,955027634,560246780,423100976,137145804,256700947,166400029
Periyar,Kaziranga,Periyar-Kaziranga,BEN_SI5,BEN_NE2,761921482,690558736,401287743,71362746,289270993,173092267,1343835283,1299687777,44147506,344660143,955027634,1250511108,1174630426,75880682,233913209,940717217
Periyar,Kaziranga,Periyar-Kaziranga,BEN_SI5,BEN_NE3,621515314,555821259,275415655,65694055,280405604,121563726,1343835283,1299687777,44147506,344660143,955027634,1008859852,937520336,71339516,277485474,660034862
Periyar,Lalgarh,Periyar-Lalgarh,BEN_SI5,LGS1,420997788,339864370,75401775,81133418,264462595,52560105,1343835283,1299687777,44147506,344660143,955027634,737843728,638009894,99833834,404772144,233237750
Periyar,Ranthambore,Periyar-Ranthambore,BEN_SI5,BEN_NW10,737666867,684384379,332641304,53282488,351743075,190268084,1343835283,1299687777,44147506,344660143,955027634,1266198710,1229664069,36534641,328923565,900740504
Periyar,Ranthambore,Periyar-Ranthambore,BEN_SI5,BEN_NW11,555238494,502725647,213595484,52512847,289130163,125656499,1343835283,1299687777,44147506,344660143,955027634,997123987,950413379,46710608,263905963,686507416
Periyar,Ranthambore,Periyar-Ranthambore,BEN_SI5,BEN_NW12,724251259,672713253,360727322,51538006,311985931,163593733,1343835283,1299687777,44147506,344660143,955027634,1267506856,1231795407,35711449,227052846,1004742561
Periyar,Ranthambore,Periyar-Ranthambore,BEN_SI5,BEN_NW13,691968370,636229142,293639374,55739228,342589768,185606746,1343835283,1299687777,44147506,344660143,955027634,1183131254,1138285233,44846021,344174628,794110605
Periyar,Ranthambore,Periyar-Ranthambore,BEN_SI5,BEN_NW14,713306385,657409469,378726421,55896916,278683048,169397982,1343835283,1299687777,44147506,344660143,955027634,1235716540,1190952996,44763544,177541519,1013411477
Periyar,Ranthambore,Periyar-Ranthambore,BEN_SI5,BEN_NW17,675277530,632347458,342169058,42930072,290178400,158683276,1343835283,1299687777,44147506,344660143,955027634,1116321554,1085802823,30518731,256140006,829662817
Periyar,Ranthambore,Periyar-Ranthambore,BEN_SI5,BEN_NW18,798375915,747528693,414682592,50847222,332846101,181180299,1343835283,1299687777,44147506,344660143,955027634,1339364699,1300736006,38628693,242877521,1057858485
Periyar,Ranthambore,Periyar-Ranthambore,BEN_SI5,BEN_NW19,660066569,608135338,325207147,51931231,282928191,133760230,1343835283,1299687777,44147506,344660143,955027634,1081768306,1036331080,45437226,232322355,804008725
Periyar,Ranthambore,Periyar-Ranthambore,BEN_SI5,BEN_NW20,650418584,583734481,188179512,66684103,395554969,127878494,1343835283,1299687777,44147506,344660143,955027634,1086271749,1022278981,63992768,541693814,480585167
Periyar,Ranthambore,Periyar-Ranthambore,BEN_SI5,BEN_NW24,675236559,615534085,301319174,59702474,314214911,168394690,1343835283,1299687777,44147506,344660143,955027634,1159641386,1113494396,46146990,301627698,811866698
Periyar,Ranthambore,Periyar-Ranthambore,BEN_SI5,BEN_NW3,813860645,763585427,471588714,50275218,291996713,213279125,1343835283,1299687777,44147506,344660143,955027634,1280728709,1240123254,40605455,207797688,1032325566
Periyar,Ranthambore,Periyar-Ranthambore,BEN_SI5,BEN_NW4,686973948,638575452,369639213,48398496,268936239,162901983,1343835283,1299687777,44147506,344660143,955027634,1219365724,1186222475,33143249,158691252,1027531223
Periyar,Ranthambore,Periyar-Ranthambore,BEN_SI5,BEN_NW5,586958483,531119194,275753390,55839289,255365804,130417833,1343835283,1299687777,44147506,344660143,955027634,977809134,918585062,59224072,241966240,676618822
Periyar,Ranthambore,Periyar-Ranthambore,BEN_SI5,BEN_NW55,657728758,594553809,185543599,63174949,409010210,136686718,1343835283,1299687777,44147506,344660143,955027634,1131174741,1073214798,57959943,534097691,539117107
Periyar,Ranthambore,Periyar-Ranthambore,BEN_SI5,BEN_NW57,693891453,608651986,167801037,85239467,440850949,125423135,1343835283,1299687777,44147506,344660143,955027634,1180288036,1103120235,77167801,638361097,464759138
Periyar,Ranthambore,Periyar-Ranthambore,BEN_SI5,BEN_NW6,586599654,538060425,280922328,48539229,257138097,135036313,1343835283,1299687777,44147506,344660143,955027634,992143483,946435718,45707765,248527765,697907953
Periyar,Ranthambore,Periyar-Ranthambore,BEN_SI5,BEN_NW8,705422579,655326596,324634250,50095983,330692346,171949339,1343835283,1299687777,44147506,344660143,955027634,1196839698,1156984240,39855458,275076038,881908202
Periyar,Ranthambore,Periyar-Ranthambore,BEN_SI5,BEN_NW9,714197574,656547913,350064849,57649661,306483064,161210909,1343835283,1299687777,44147506,344660143,955027634,1246521228,1203200533,43320695,216389572,986810961
Periyar,Wayanad,Periyar-Wayanad,BEN_SI5,BEN_SI1,529757737,446941261,157637889,82816476,289303372,84056431,1343835283,1299687777,44147506,344660143,955027634,897358653,799698739,97659914,345341326,454357413
Periyar,Wayanad,Periyar-Wayanad,BEN_SI5,BEN_SI11,395298268,361196880,156773827,34101388,204423053,85855691,1343835283,1299687777,44147506,344660143,955027634,641166204,612648765,28517439,241001807,371646958
Periyar,Wayanad,Periyar-Wayanad,BEN_SI5,BEN_SI2,385370688,369338929,186638742,16031759,182700187,75775537,1343835283,1299687777,44147506,344660143,955027634,650993225,648515374,2477851,140667619,507847755
Periyar,Wayanad,Periyar-Wayanad,BEN_SI5,BEN_SI3,547465516,476212278,183983275,71253238,292229003,99957713,1343835283,1299687777,44147506,344660143,955027634,931565359,847325564,84239795,345974583,501350981
Periyar,Wayanad,Periyar-Wayanad,BEN_SI5,BEN_SI4,656737098,584837026,298655121,71900072,286181905,115695856,1343835283,1299687777,44147506,344660143,955027634,1109312253,1030580255,78731998,302255092,728325163
Periyar,Wayanad,Periyar-Wayanad,BEN_SI5,BEN_SI6,548876579,470723297,184853943,78153282,285869354,109371987,1343835283,1299687777,44147506,344660143,955027634,951080464,864453508,86626956,319674486,544779022
Periyar,Wayanad,Periyar-Wayanad,BEN_SI5,BEN_SI7,554057912,479559749,196672836,74498163,282886913,99126602,1343835283,1299687777,44147506,344660143,955027634,942430262,853584663,88845599,335397181,518187482
Periyar,Wayanad,Periyar-Wayanad,BEN_SI5,BEN_SI8,655546755,583390865,297002888,72155890,286387977,124238434,1343835283,1299687777,44147506,344660143,955027634,1108177315,1029030472,79146843,300308119,728722353
Periyar,Wayanad,Periyar-Wayanad,BEN_SI5,BEN_SI9,501150585,418016623,150375832,83133962,267640791,83327312,1343835283,1299687777,44147506,344660143,955027634,849233213,745820153,103413060,339499389,406320764
Periyar,Zoo,Periyar-Zoo,BEN_SI5,ZSB_01,430003569,360923942,149074456,69079627,211849486,66448841,1343835283,1299687777,44147506,344660143,955027634,723092447,635855373,87237074,256023333,379832040
Periyar,Zoo,Periyar-Zoo,BEN_SI5,ZSB_02,527453156,461075273,202962181,66377883,258113092,110374954,1343835283,1299687777,44147506,344660143,955027634,942790346,865053483,77736863,260820720,604232763
Periyar,Zoo,Periyar-Zoo,BEN_SI5,ZSB_03,522011107,465245085,236667779,56766022,228577306,117855100,1343835283,1299687777,44147506,344660143,955027634,892317758,827799945,64517813,241409256,586390689
Periyar,Zoo,Periyar-Zoo,BEN_SI5,ZSB_04,510766056,452665972,199582366,58100084,253083606,115192223,1343835283,1299687777,44147506,344660143,955027634,867386629,799476794,67909835,302302125,497174669
Periyar,Zoo,Periyar-Zoo,BEN_SI5,ZSB_05,511291845,442551679,208986330,68740166,233565349,89172281,1343835283,1299687777,44147506,344660143,955027634,864922054,784467789,80454265,246263826,538203963
Ranthambore,Chandrapur,Ranthambore-Chandrapur,BEN_NW10,BEN_CI2,362043632,337221763,144895008,24821869,192326755,75859156,1266198710,1229664069,36534641,328923565,900740504,674364895,657438378,16926517,229909737,427528641
Ranthambore,Chandrapur,Ranthambore-Chandrapur,BEN_NW11,BEN_CI2,308506905,285459882,122979467,23047023,162480415,60742572,997123987,950413379,46710608,263905963,686507416,674364895,657438378,16926517,229909737,427528641
Ranthambore,Chandrapur,Ranthambore-Chandrapur,BEN_NW12,BEN_CI2,398680733,378494959,205187792,20185774,173307167,80515584,1267506856,1231795407,35711449,227052846,1004742561,674364895,657438378,16926517,229909737,427528641
Ranthambore,Chandrapur,Ranthambore-Chandrapur,BEN_NW13,BEN_CI2,345029055,317261877,119665843,27767178,197596034,57808473,1183131254,1138285233,44846021,344174628,794110605,674364895,657438378,16926517,229909737,427528641
Ranthambore,Chandrapur,Ranthambore-Chandrapur,BEN_NW14,BEN_CI2,377851317,353479872,183283769,24371445,170196103,59291348,1235716540,1190952996,44763544,177541519,1013411477,674364895,657438378,16926517,229909737,427528641
Ranthambore,Chandrapur,Ranthambore-Chandrapur,BEN_NW17,BEN_CI2,314269223,292004715,114424597,22264508,177580118,50086971,1116321554,1085802823,30518731,256140006,829662817,674364895,657438378,16926517,229909737,427528641
Ranthambore,Chandrapur,Ranthambore-Chandrapur,BEN_NW18,BEN_CI2,411604753,387541509,191751416,24063244,195790093,71115300,1339364699,1300736006,38628693,242877521,1057858485,674364895,657438378,16926517,229909737,427528641
Ranthambore,Chandrapur,Ranthambore-Chandrapur,BEN_NW19,BEN_CI2,311510615,288236899,132129397,23273716,156107502,48111075,1081768306,1036331080,45437226,232322355,804008725,674364895,657438378,16926517,229909737,427528641
Ranthambore,Chandrapur,Ranthambore-Chandrapur,BEN_NW20,BEN_CI2,319360740,289107152,61728792,30253588,227378360,45367716,1086271749,1022278981,63992768,541693814,480585167,674364895,657438378,16926517,229909737,427528641
Ranthambore,Chandrapur,Ranthambore-Chandrapur,BEN_NW24,BEN_CI2,359098263,335322761,142841706,23775502,192481055,71364341,1159641386,1113494396,46146990,301627698,811866698,674364895,657438378,16926517,229909737,427528641
Ranthambore,Chandrapur,Ranthambore-Chandrapur,BEN_NW3,BEN_CI2,356852472,332553252,140691409,24299220,191861843,65840635,1280728709,1240123254,40605455,207797688,1032325566,674364895,657438378,16926517,229909737,427528641
Ranthambore,Chandrapur,Ranthambore-Chandrapur,BEN_NW4,BEN_CI2,356947098,336842437,179658470,20104661,157183967,53660408,1219365724,1186222475,33143249,158691252,1027531223,674364895,657438378,16926517,229909737,427528641
Ranthambore,Chandrapur,Ranthambore-Chandrapur,BEN_NW5,BEN_CI2,294140712,266041069,115907749,28099643,150133320,38272001,977809134,918585062,59224072,241966240,676618822,674364895,657438378,16926517,229909737,427528641
Ranthambore,Chandrapur,Ranthambore-Chandrapur,BEN_NW55,BEN_CI2,329852721,298778774,71926685,31073947,226852089,54317888,1131174741,1073214798,57959943,534097691,539117107,674364895,657438378,16926517,229909737,427528641
Ranthambore,Chandrapur,Ranthambore-Chandrapur,BEN_NW57,BEN_CI2,352381693,316437132,73433616,35944561,243003516,51660010,1180288036,1103120235,77167801,638361097,464759138,674364895,657438378,16926517,229909737,427528641
Ranthambore,Chandrapur,Ranthambore-Chandrapur,BEN_NW6,BEN_CI2,268849152,245042102,98019898,23807050,147022204,48534070,992143483,946435718,45707765,248527765,697907953,674364895,657438378,16926517,229909737,427528641
Ranthambore,Chandrapur,Ranthambore-Chandrapur,BEN_NW8,BEN_CI2,379023949,355242342,174747990,23781607,180494352,75980144,1196839698,1156984240,39855458,275076038,881908202,674364895,657438378,16926517,229909737,427528641
Ranthambore,Chandrapur,Ranthambore-Chandrapur,BEN_NW9,BEN_CI2,353650541,328637330,143349859,25013211,185287471,64952278,1246521228,1203200533,43320695,216389572,986810961,674364895,657438378,16926517,229909737,427528641
Ranthambore,Corbett,Ranthambore-Corbett,BEN_NW10,BEN_NOR1,374021723,304128456,61403022,69893267,242725434,52290617,1266198710,1229664069,36534641,328923565,900740504,689133358,592060124,97073234,396388890,195671234
Ranthambore,Corbett,Ranthambore-Corbett,BEN_NW10,BEN_NOR2,491446895,413073805,159641043,78373090,253432762,96747129,1266198710,1229664069,36534641,328923565,900740504,872604239,770086648,102517591,315997124,454089524
Ranthambore,Corbett,Ranthambore-Corbett,BEN_NW11,BEN_NOR1,302791235,242767310,50171821,60023925,192595489,39587252,997123987,950413379,46710608,263905963,686507416,689133358,592060124,97073234,396388890,195671234
Ranthambore,Corbett,Ranthambore-Corbett,BEN_NW11,BEN_NOR2,370751616,304726199,118697081,66025417,186029118,61154819,997123987,950413379,46710608,263905963,686507416,872604239,770086648,102517591,315997124,454089524
Ranthambore,Corbett,Ranthambore-Corbett,BEN_NW12,BEN_NOR1,393922808,325462952,78926299,68459856,246536653,60187875,1267506856,1231795407,35711449,227052846,1004742561,689133358,592060124,97073234,396388890,195671234
Ranthambore,Corbett,Ranthambore-Corbett,BEN_NW12,BEN_NOR2,494524811,422125720,209282756,72399091,212842964,67409833,1267506856,1231795407,35711449,227052846,1004742561,872604239,770086648,102517591,315997124,454089524
Ranthambore,Corbett,Ranthambore-Corbett,BEN_NW13,BEN_NOR1,353827385,285084317,57846240,68743068,227238077,45047858,1183131254,1138285233,44846021,344174628,794110605,689133358,592060124,97073234,396388890,195671234
Ranthambore,Corbett,Ranthambore-Corbett,BEN_NW13,BEN_NOR2,475573557,405177382,175924501,70396175,229252881,99981354,1183131254,1138285233,44846021,344174628,794110605,872604239,770086648,102517591,315997124,454089524
Ranthambore,Corbett,Ranthambore-Corbett,BEN_NW14,BEN_NOR1,386853407,320611130,84942253,66242277,235668877,58211723,1235716540,1190952996,44763544,177541519,1013411477,689133358,592060124,97073234,396388890,195671234
Ranthambore,Corbett,Ranthambore-Corbett,BEN_NW14,BEN_NOR2,479663082,406349990,203068190,73313092,203281800,63473636,1235716540,1190952996,44763544,177541519,1013411477,872604239,770086648,102517591,315997124,454089524
Ranthambore,Corbett,Ranthambore-Corbett,BEN_NW17,BEN_NOR1,337005987,275224906,52530849,61781081,222694057,42289023,1116321554,1085802823,30518731,256140006,829662817,689133358,592060124,97073234,396388890,195671234
Ranthambore,Corbett,Ranthambore-Corbett,BEN_NW17,BEN_NOR2,415523724,348010999,138561422,67512725,209449577,63402699,1116321554,1085802823,30518731,256140006,829662817,872604239,770086648,102517591,315997124,454089524
Ranthambore,Corbett,Ranthambore-Corbett,BEN_NW18,BEN_NOR1,422117639,354647955,109040149,67469684,245607806,73828969,1339364699,1300736006,38628693,242877521,1057858485,689133358,592060124,97073234,396388890,195671234
Ranthambore,Corbett,Ranthambore-Corbett,BEN_NW18,BEN_NOR2,539511186,463526030,223326806,75985156,240199224,92321181,1339364699,1300736006,38628693,242877521,1057858485,872604239,770086648,102517591,315997124,454089524
Ranthambore,Corbett,Ranthambore-Corbett,BEN_NW19,BEN_NOR1,328872692,264031266,58975420,64841426,205055846,40367719,1081768306,1036331080,45437226,232322355,804008725,689133358,592060124,97073234,396388890,195671234
Ranthambore,Corbett,Ranthambore-Corbett,BEN_NW19,BEN_NOR2,407453343,338709643,132713976,68743700,205995667,56652694,1081768306,1036331080,45437226,232322355,804008725,872604239,770086648,102517591,315997124,454089524
Ranthambore,Corbett,Ranthambore-Corbett,BEN_NW20,BEN_NOR1,335309553,261114854,32708727,74194699,228406127,32708727,1086271749,1022278981,63992768,541693814,480585167,689133358,592060124,97073234,396388890,195671234
Ranthambore,Corbett,Ranthambore-Corbett,BEN_NW20,BEN_NOR2,447142532,370283523,102841512,76859009,267442011,66034090,1086271749,1022278981,63992768,541693814,480585167,872604239,770086648,102517591,315997124,454089524
Ranthambore,Corbett,Ranthambore-Corbett,BEN_NW24,BEN_NOR1,356261902,284800628,51487648,71461274,233312980,43439943,1159641386,1113494396,46146990,301627698,811866698,689133358,592060124,97073234,396388890,195671234
Ranthambore,Corbett,Ranthambore-Corbett,BEN_NW24,BEN_NOR2,437185644,362150507,132124026,75035137,230026481,72438751,1159641386,1113494396,46146990,301627698,811866698,872604239,770086648,102517591,315997124,454089524
Ranthambore,Corbett,Ranthambore-Corbett,BEN_NW3,BEN_NOR1,395086973,326896924,87331729,68190049,239565195,58318114,1280728709,1240123254,40605455,207797688,1032325566,689133358,592060124,97073234,396388890,195671234
Ranthambore,Corbett,Ranthambore-Corbett,BEN_NW3,BEN_NOR2,515178902,441456009,232923971,73722893,208532038,68782170,1280728709,1240123254,40605455,207797688,1032325566,872604239,770086648,102517591,315997124,454089524
Ranthambore,Corbett,Ranthambore-Corbett,BEN_NW4,BEN_NOR1,364161239,300995083,77471826,63166156,223523257,52775350,1219365724,1186222475,33143249,158691252,1027531223,689133358,592060124,97073234,396388890,195671234
Ranthambore,Corbett,Ranthambore-Corbett,BEN_NW4,BEN_NOR2,495339143,431578260,237861211,63760883,193717049,57647042,1219365724,1186222475,33143249,158691252,1027531223,872604239,770086648,102517591,315997124,454089524
Ranthambore,Corbett,Ranthambore-Corbett,BEN_NW5,BEN_NOR1,292531779,226077402,49906627,66454377,176170775,31331679,977809134,918585062,59224072,241966240,676618822,689133358,592060124,97073234,396388890,195671234
Ranthambore,Corbett,Ranthambore-Corbett,BEN_NW5,BEN_NOR2,397515209,331339881,138875699,66175328,192464182,59965866,977809134,918585062,59224072,241966240,676618822,872604239,770086648,102517591,315997124,454089524
Ranthambore,Corbett,Ranthambore-Corbett,BEN_NW55,BEN_NOR1,338667370,265529533,32069181,73137837,233460352,32069181,1131174741,1073214798,57959943,534097691,539117107,689133358,592060124,97073234,396388890,195671234
Ranthambore,Corbett,Ranthambore-Corbett,BEN_NW55,BEN_NOR2,449629250,371947721,115902723,77681529,256044998,76258392,1131174741,1073214798,57959943,534097691,539117107,872604239,770086648,102517591,315997124,454089524
Ranthambore,Corbett,Ranthambore-Corbett,BEN_NW57,BEN_NOR1,353897381,266573675,18933560,87323706,247640115,18933560,1180288036,1103120235,77167801,638361097,464759138,689133358,592060124,97073234,396388890,195671234
Ranthambore,Corbett,Ranthambore-Corbett,BEN_NW57,BEN_NOR2,467390300,377147269,96504333,90243031,280642936,60507387,1180288036,1103120235,77167801,638361097,464759138,872604239,770086648,102517591,315997124,454089524
Ranthambore,Corbett,Ranthambore-Corbett,BEN_NW6,BEN_NOR1,311152195,255312322,63031998,55839873,192280324,49623665,992143483,946435718,45707765,248527765,697907953,689133358,592060124,97073234,396388890,195671234
Ranthambore,Corbett,Ranthambore-Corbett,BEN_NW6,BEN_NOR2,393363806,333404869,145870078,59958937,187534791,65289357,992143483,946435718,45707765,248527765,697907953,872604239,770086648,102517591,315997124,454089524
Ranthambore,Corbett,Ranthambore-Corbett,BEN_NW8,BEN_NOR1,363092456,297517660,67641984,65574796,229875676,51699906,1196839698,1156984240,39855458,275076038,881908202,689133358,592060124,97073234,396388890,195671234
Ranthambore,Corbett,Ranthambore-Corbett,BEN_NW8,BEN_NOR2,460575623,389691238,157522566,70884385,232168672,77984590,1196839698,1156984240,39855458,275076038,881908202,872604239,770086648,102517591,315997124,454089524
Ranthambore,Corbett,Ranthambore-Corbett,BEN_NW9,BEN_NOR1,373841106,304188822,76145452,69652284,228043370,63892297,1246521228,1203200533,43320695,216389572,986810961,689133358,592060124,97073234,396388890,195671234
Ranthambore,Corbett,Ranthambore-Corbett,BEN_NW9,BEN_NOR2,484165805,411161889,189123305,73003916,222038584,58447929,1246521228,1203200533,43320695,216389572,986810961,872604239,770086648,102517591,315997124,454089524
Ranthambore,Kanha,Ranthambore-Kanha,BEN_NW10,BEN_CI15,324712376,245908001,59950287,78804375,185957714,30546207,1266198710,1229664069,36534641,328923565,900740504,558426844,440368350,118058494,313676252,126692098
Ranthambore,Kanha,Ranthambore-Kanha,BEN_NW10,BEN_CI16,544061053,485058909,261806463,59002144,223252446,109703410,1266198710,1229664069,36534641,328923565,900740504,941465693,865515372,75950321,260165870,605349502
Ranthambore,Kanha,Ranthambore-Kanha,BEN_NW10,BEN_CI18,300862620,223144930,49376807,77717690,173768123,34070700,1266198710,1229664069,36534641,328923565,900740504,531335982,416398696,114937286,280261230,136137466
Ranthambore,Kanha,Ranthambore-Kanha,BEN_NW10,BEN_CI19,214082160,142226529,8800485,71855631,133426044,8800485,1266198710,1229664069,36534641,328923565,900740504,370653731,261143653,109510078,241812071,19331582
Ranthambore,Kanha,Ranthambore-Kanha,BEN_NW10,BEN_CI3,361127430,286509509,86276986,74617921,200232523,48975068,1266198710,1229664069,36534641,328923565,900740504,399948004,398407865,1540139,114426239,283981626
Ranthambore,Kanha,Ranthambore-Kanha,BEN_NW10,BEN_CI4,351277051,293493405,119112212,57783646,174381193,62950241,1266198710,1229664069,36534641,328923565,900740504,588039664,506748544,81291120,270707157,236041387
Ranthambore,Kanha,Ranthambore-Kanha,BEN_NW10,BEN_CI5,252175960,194444468,26097934,57731492,168346534,16773799,1266198710,1229664069,36534641,328923565,900740504,447217937,358814659,88403278,289122614,69692045
Ranthambore,Kanha,Ranthambore-Kanha,BEN_NW10,BEN_CI6,324208626,254533817,69494375,69674809,185039442,40599416,1266198710,1229664069,36534641,328923565,900740504,558093435,456569955,101523480,304633087,151936868
Ranthambore,Kanha,Ranthambore-Kanha,BEN_NW10,BEN_CI7,420572938,398061715,233116129,22511223,164945586,101614792,1266198710,1229664069,36534641,328923565,900740504,746271387,730520258,15751129,197580294,532939964
Ranthambore,Kanha,Ranthambore-Kanha,BEN_NW11,BEN_CI15,249622748,186976515,41494542,62646233,145481973,20640253,997123987,950413379,46710608,263905963,686507416,558426844,440368350,118058494,313676252,126692098
Ranthambore,Kanha,Ranthambore-Kanha,BEN_NW11,BEN_CI16,394812162,340378328,151905811,54433834,188472517,62959676,997123987,950413379,46710608,263905963,686507416,941465693,865515372,75950321,260165870,605349502
Ranthambore,Kanha,Ranthambore-Kanha,BEN_NW11,BEN_CI18,233654266,172033038,37098604,61621228,134934434,18770341,997123987,950413379,46710608,263905963,686507416,531335982,416398696,114937286,280261230,136137466
Ranthambore,Kanha,Ranthambore-Kanha,BEN_NW11,BEN_CI19,162714188,104981680,6457992,57732508,98523688,6457992,997123987,950413379,46710608,263905963,686507416,370653731,261143653,109510078,241812071,19331582
Ranthambore,Kanha,Ranthambore-Kanha,BEN_NW11,BEN_CI3,288654182,229561410,79433432,59092772,150127978,41908131,997123987,950413379,46710608,263905963,686507416,399948004,398407865,1540139,114426239,283981626
Ranthambore,Kanha,Ranthambore-Kanha,BEN_NW11,BEN_CI4,280966127,234430492,91338495,46535635,143091997,36236010,997123987,950413379,46710608,263905963,686507416,588039664,506748544,81291120,270707157,236041387
Ranthambore,Kanha,Ranthambore-Kanha,BEN_NW11,BEN_CI5,193402553,145233949,20055342,48168604,125178607,17984870,997123987,950413379,46710608,263905963,686507416,447217937,358814659,88403278,289122614,69692045
Ranthambore,Kanha,Ranthambore-Kanha,BEN_NW11,BEN_CI6,257104894,200510796,51584373,56594098,148926423,31262870,997123987,950413379,46710608,263905963,686507416,558093435,456569955,101523480,304633087,151936868
Ranthambore,Kanha,Ranthambore-Kanha,BEN_NW11,BEN_CI7,330993846,307739953,162034540,23253893,145705413,54621227,997123987,950413379,46710608,263905963,686507416,746271387,730520258,15751129,197580294,532939964
Ranthambore,Kanha,Ranthambore-Kanha,BEN_NW12,BEN_CI15,318112468,242423055,55560912,75689413,186862143,24899206,1267506856,1231795407,35711449,227052846,1004742561,558426844,440368350,118058494,313676252,126692098
Ranthambore,Kanha,Ranthambore-Kanha,BEN_NW12,BEN_CI16,545783579,491520728,288507380,54262851,203013348,97939512,1267506856,1231795407,35711449,227052846,1004742561,941465693,865515372,75950321,260165870,605349502
Ranthambore,Kanha,Ranthambore-Kanha,BEN_NW12,BEN_CI18,294752960,220920567,49483170,73832393,171437397,39578573,1267506856,1231795407,35711449,227052846,1004742561,531335982,416398696,114937286,280261230,136137466
Ranthambore,Kanha,Ranthambore-Kanha,BEN_NW12,BEN_CI19,203614189,134630572,5791192,68983617,128839380,5791192,1267506856,1231795407,35711449,227052846,1004742561,370653731,261143653,109510078,241812071,19331582
Ranthambore,Kanha,Ranthambore-Kanha,BEN_NW12,BEN_CI3,337025339,261918409,75260795,75106930,186657614,37864281,1267506856,1231795407,35711449,227052846,1004742561,399948004,398407865,1540139,114426239,283981626
Ranthambore,Kanha,Ranthambore-Kanha,BEN_NW12,BEN_CI4,336109177,283190380,113629422,52918797,169560958,43479631,1267506856,1231795407,35711449,227052846,1004742561,588039664,506748544,81291120,270707157,236041387
Ranthambore,Kanha,Ranthambore-Kanha,BEN_NW12,BEN_CI5,254621271,199271182,35429240,55350089,163841942,19563953,1267506856,1231795407,35711449,227052846,1004742561,447217937,358814659,88403278,289122614,69692045
Ranthambore,Kanha,Ranthambore-Kanha,BEN_NW12,BEN_CI6,313355463,245497807,63436165,67857656,182061642,22239955,1267506856,1231795407,35711449,227052846,1004742561,558093435,456569955,101523480,304633087,151936868
Ranthambore,Kanha,Ranthambore-Kanha,BEN_NW12,BEN_CI7,434577551,412731090,238574880,21846461,174156210,58525087,1267506856,1231795407,35711449,227052846,1004742561,746271387,730520258,15751129,197580294,532939964
Ranthambore,Kanha,Ranthambore-Kanha,BEN_NW13,BEN_CI15,297751146,224393591,57702933,73357555,166690658,33447643,1183131254,1138285233,44846021,344174628,794110605,558426844,440368350,118058494,313676252,126692098
Ranthambore,Kanha,Ranthambore-Kanha,BEN_NW13,BEN_CI16,480227617,420941374,183573228,59286243,237368146,104083876,1183131254,1138285233,44846021,344174628,794110605,941465693,865515372,75950321,260165870,605349502
Ranthambore,Kanha,Ranthambore-Kanha,BEN_NW13,BEN_CI18,270350596,194447922,41747852,75902674,152700070,24891310,1183131254,1138285233,44846021,344174628,794110605,531335982,416398696,114937286,280261230,136137466
Ranthambore,Kanha,Ranthambore-Kanha,BEN_NW13,BEN_CI19,183347210,118676125,2377884,64671085,116298241,2377884,1183131254,1138285233,44846021,344174628,794110605,370653731,261143653,109510078,241812071,19331582
Ranthambore,Kanha,Ranthambore-Kanha,BEN_NW13,BEN_CI3,309019001,238317008,67382400,70701993,170934608,38414740,1183131254,1138285233,44846021,344174628,794110605,399948004,398407865,1540139,114426239,283981626
Ranthambore,Kanha,Ranthambore-Kanha,BEN_NW13,BEN_CI4,322388163,269053294,100246514,53334869,168806780,50619797,1183131254,1138285233,44846021,344174628,794110605,588039664,506748544,81291120,270707157,236041387
Ranthambore,Kanha,Ranthambore-Kanha,BEN_NW13,BEN_CI5,234153547,178130140,21982086,56023407,156148054,17172049,1183131254,1138285233,44846021,344174628,794110605,447217937,358814659,88403278,289122614,69692045
Ranthambore,Kanha,Ranthambore-Kanha,BEN_NW13,BEN_CI6,303601617,237631971,54700241,65969646,182931730,36773562,1183131254,1138285233,44846021,344174628,794110605,558093435,456569955,101523480,304633087,151936868
Ranthambore,Kanha,Ranthambore-Kanha,BEN_NW13,BEN_CI7,386775625,365951506,169123460,20824119,196828046,80098029,1183131254,1138285233,44846021,344174628,794110605,746271387,730520258,15751129,197580294,532939964
Ranthambore,Kanha,Ranthambore-Kanha,BEN_NW14,BEN_CI15,308698709,234863570,64265624,73835139,170597946,26315449,1235716540,1190952996,44763544,177541519,1013411477,558426844,440368350,118058494,313676252,126692098
Ranthambore,Kanha,Ranthambore-Kanha,BEN_NW14,BEN_CI16,524396838,467068878,275504170,57327960,191564708,81023970,1235716540,1190952996,44763544,177541519,1013411477,941465693,865515372,75950321,260165870,605349502
Ranthambore,Kanha,Ranthambore-Kanha,BEN_NW14,BEN_CI18,293753590,220586635,53478630,73166955,167108005,28969342,1235716540,1190952996,44763544,177541519,1013411477,531335982,416398696,114937286,280261230,136137466
Ranthambore,Kanha,Ranthambore-Kanha,BEN_NW14,BEN_CI19,204061618,136040805,10717691,68020813,125323114,10717691,1235716540,1190952996,44763544,177541519,1013411477,370653731,261143653,109510078,241812071,19331582
Ranthambore,Kanha,Ranthambore-Kanha,BEN_NW14,BEN_CI3,361436241,292416531,129191220,69019710,163225311,49253417,1235716540,1190952996,44763544,177541519,1013411477,399948004,398407865,1540139,114426239,283981626
Ranthambore,Kanha,Ranthambore-Kanha,BEN_NW14,BEN_CI4,319143796,266977882,106349314,52165914,160628568,39697338,1235716540,1190952996,44763544,177541519,1013411477,588039664,506748544,81291120,270707157,236041387
Ranthambore,Kanha,Ranthambore-Kanha,BEN_NW14,BEN_CI5,248871042,193375334,26064671,55495708,167310663,17756662,1235716540,1190952996,44763544,177541519,1013411477,447217937,358814659,88403278,289122614,69692045
Ranthambore,Kanha,Ranthambore-Kanha,BEN_NW14,BEN_CI6,295106018,229787624,67365839,65318394,162421785,31156502,1235716540,1190952996,44763544,177541519,1013411477,558093435,456569955,101523480,304633087,151936868
Ranthambore,Kanha,Ranthambore-Kanha,BEN_NW14,BEN_CI7,447474412,426284012,273354978,21190400,152929034,52110613,1235716540,1190952996,44763544,177541519,1013411477,746271387,730520258,15751129,197580294,532939964
Ranthambore,Kanha,Ranthambore-Kanha,BEN_NW17,BEN_CI15,273085979,202833690,43178895,70252289,159654795,19710140,1116321554,1085802823,30518731,256140006,829662817,558426844,440368350,118058494,313676252,126692098
Ranthambore,Kanha,Ranthambore-Kanha,BEN_NW17,BEN_CI16,437406866,382730226,192948576,54676640,189781650,77846984,1116321554,1085802823,30518731,256140006,829662817,941465693,865515372,75950321,260165870,605349502
Ranthambore,Kanha,Ranthambore-Kanha,BEN_NW17,BEN_CI18,255430276,185816940,43489564,69613336,142327376,18131005,1116321554,1085802823,30518731,256140006,829662817,531335982,416398696,114937286,280261230,136137466
Ranthambore,Kanha,Ranthambore-Kanha,BEN_NW17,BEN_CI19,188325592,122923960,8965938,65401632,113958022,8965938,1116321554,1085802823,30518731,256140006,829662817,370653731,261143653,109510078,241812071,19331582
Ranthambore,Kanha,Ranthambore-Kanha,BEN_NW17,BEN_CI3,327275088,262896052,101959819,64379036,160936233,35178724,1116321554,1085802823,30518731,256140006,829662817,399948004,398407865,1540139,114426239,283981626
Ranthambore,Kanha,Ranthambore-Kanha,BEN_NW17,BEN_CI4,293274937,241103084,80832311,52171853,160270773,31434256,1116321554,1085802823,30518731,256140006,829662817,588039664,506748544,81291120,270707157,236041387
Ranthambore,Kanha,Ranthambore-Kanha,BEN_NW17,BEN_CI5,228806884,177581201,21511807,51225683,156069394,16951975,1116321554,1085802823,30518731,256140006,829662817,447217937,358814659,88403278,289122614,69692045
Ranthambore,Kanha,Ranthambore-Kanha,BEN_NW17,BEN_CI6,253477168,191347709,34722802,62129459,156624907,13379887,1116321554,1085802823,30518731,256140006,829662817,558093435,456569955,101523480,304633087,151936868
Ranthambore,Kanha,Ranthambore-Kanha,BEN_NW17,BEN_CI7,377899943,361094943,203043071,16805000,158051872,59947239,1116321554,1085802823,30518731,256140006,829662817,746271387,730520258,15751129,197580294,532939964
Ranthambore,Kanha,Ranthambore-Kanha,BEN_NW18,BEN_CI15,343028683,264094396,73796135,78934287,190298261,28757710,1339364699,1300736006,38628693,242877521,1057858485,558426844,440368350,118058494,313676252,126692098
Ranthambore,Kanha,Ranthambore-Kanha,BEN_NW18,BEN_CI16,543969239,483430743,264883342,60538496,218547401,71442771,1339364699,1300736006,38628693,242877521,1057858485,941465693,865515372,75950321,260165870,605349502
Ranthambore,Kanha,Ranthambore-Kanha,BEN_NW18,BEN_CI18,321897492,244896478,68527386,77001014,176369092,37707974,1339364699,1300736006,38628693,242877521,1057858485,531335982,416398696,114937286,280261230,136137466
Ranthambore,Kanha,Ranthambore-Kanha,BEN_NW18,BEN_CI19,216361275,143287704,6542271,73073571,136745433,6542271,1339364699,1300736006,38628693,242877521,1057858485,370653731,261143653,109510078,241812071,19331582
Ranthambore,Kanha,Ranthambore-Kanha,BEN_NW18,BEN_CI3,379331231,305817928,112197603,73513303,193620325,53706000,1339364699,1300736006,38628693,242877521,1057858485,399948004,398407865,1540139,114426239,283981626
Ranthambore,Kanha,Ranthambore-Kanha,BEN_NW18,BEN_CI4,339330938,282291756,89671476,57039182,192620280,31699166,1339364699,1300736006,38628693,242877521,1057858485,588039664,506748544,81291120,270707157,236041387
Ranthambore,Kanha,Ranthambore-Kanha,BEN_NW18,BEN_CI5,271800674,213146071,30439778,58654603,182706293,15089502,1339364699,1300736006,38628693,242877521,1057858485,447217937,358814659,88403278,289122614,69692045
Ranthambore,Kanha,Ranthambore-Kanha,BEN_NW18,BEN_CI6,337232755,270572674,76276768,66660081,194295906,33896397,1339364699,1300736006,38628693,242877521,1057858485,558093435,456569955,101523480,304633087,151936868
Ranthambore,Kanha,Ranthambore-Kanha,BEN_NW18,BEN_CI7,444931073,423848550,253254703,21082523,170593847,71552751,1339364699,1300736006,38628693,242877521,1057858485,746271387,730520258,15751129,197580294,532939964
Ranthambore,Kanha,Ranthambore-Kanha,BEN_NW19,BEN_CI15,267483459,197567354,34915985,69916105,162651369,14697859,1081768306,1036331080,45437226,232322355,804008725,558426844,440368350,118058494,313676252,126692098
Ranthambore,Kanha,Ranthambore-Kanha,BEN_NW19,BEN_CI16,437045060,378471179,191396910,58573881,187074269,58813098,1081768306,1036331080,45437226,232322355,804008725,941465693,865515372,75950321,260165870,605349502
Ranthambore,Kanha,Ranthambore-Kanha,BEN_NW19,BEN_CI18,263350770,194005833,49957357,69344937,144048476,22798028,1081768306,1036331080,45437226,232322355,804008725,531335982,416398696,114937286,280261230,136137466
Ranthambore,Kanha,Ranthambore-Kanha,BEN_NW19,BEN_CI19,177776618,115748818,6032983,62027800,109715835,6032983,1081768306,1036331080,45437226,232322355,804008725,370653731,261143653,109510078,241812071,19331582
Ranthambore,Kanha,Ranthambore-Kanha,BEN_NW19,BEN_CI3,308161778,238126457,91722161,70035321,146404296,29561949,1081768306,1036331080,45437226,232322355,804008725,399948004,398407865,1540139,114426239,283981626
Ranthambore,Kanha,Ranthambore-Kanha,BEN_NW19,BEN_CI4,289833137,237807221,86512272,52025916,151294949,34867405,1081768306,1036331080,45437226,232322355,804008725,588039664,506748544,81291120,270707157,236041387
Ranthambore,Kanha,Ranthambore-Kanha,BEN_NW19,BEN_CI5,224088434,172731859,27229398,51356575,145502461,9074881,1081768306,1036331080,45437226,232322355,804008725,447217937,358814659,88403278,289122614,69692045
Ranthambore,Kanha,Ranthambore-Kanha,BEN_NW19,BEN_CI6,260265353,196897656,40272758,63367697,156624898,18484486,1081768306,1036331080,45437226,232322355,804008725,558093435,456569955,101523480,304633087,151936868
Ranthambore,Kanha,Ranthambore-Kanha,BEN_NW19,BEN_CI7,377123861,356128919,209531517,20994942,146597402,60515927,1081768306,1036331080,45437226,232322355,804008725,746271387,730520258,15751129,197580294,532939964
Ranthambore,Kanha,Ranthambore-Kanha,BEN_NW20,BEN_CI15,268050090,190776281,23258929,77273809,167517352,23258929,1086271749,1022278981,63992768,541693814,480585167,558426844,440368350,118058494,313676252,126692098
Ranthambore,Kanha,Ranthambore-Kanha,BEN_NW20,BEN_CI16,465659939,401312640,146319004,64347299,254993636,96409943,1086271749,1022278981,63992768,541693814,480585167,941465693,865515372,75950321,260165870,605349502
Ranthambore,Kanha,Ranthambore-Kanha,BEN_NW20,BEN_CI18,256586411,177763531,14330704,78822880,163432827,10379012,1086271749,1022278981,63992768,541693814,480585167,531335982,416398696,114937286,280261230,136137466
Ranthambore,Kanha,Ranthambore-Kanha,BEN_NW20,BEN_CI19,176917065,115388168,7115289,61528897,108272879,7115289,1086271749,1022278981,63992768,541693814,480585167,370653731,261143653,109510078,241812071,19331582
Ranthambore,Kanha,Ranthambore-Kanha,BEN_NW20,BEN_CI3,300254042,222923831,44968512,77330211,177955319,30846961,1086271749,1022278981,63992768,541693814,480585167,399948004,398407865,1540139,114426239,283981626
Ranthambore,Kanha,Ranthambore-Kanha,BEN_NW20,BEN_CI4,294433928,234543659,46323878,59890269,188219781,30261649,1086271749,1022278981,63992768,541693814,480585167,588039664,506748544,81291120,270707157,236041387
Ranthambore,Kanha,Ranthambore-Kanha,BEN_NW20,BEN_CI5,230832619,168897661,13178048,61934958,155719613,8101265,1086271749,1022278981,63992768,541693814,480585167,447217937,358814659,88403278,289122614,69692045
Ranthambore,Kanha,Ranthambore-Kanha,BEN_NW20,BEN_CI6,281113454,211371973,39858859,69741481,171513114,32588782,1086271749,1022278981,63992768,541693814,480585167,558093435,456569955,101523480,304633087,151936868
Ranthambore,Kanha,Ranthambore-Kanha,BEN_NW20,BEN_CI7,371585971,339910476,133041978,31675495,206868498,79399776,1086271749,1022278981,63992768,541693814,480585167,746271387,730520258,15751129,197580294,532939964
Ranthambore,Kanha,Ranthambore-Kanha,BEN_NW24,BEN_CI15,284493119,208201276,36628087,76291843,171573189,25815572,1159641386,1113494396,46146990,301627698,811866698,558426844,440368350,118058494,313676252,126692098
Ranthambore,Kanha,Ranthambore-Kanha,BEN_NW24,BEN_CI16,461867248,399659407,177699141,62207841,221960266,75173690,1159641386,1113494396,46146990,301627698,811866698,941465693,865515372,75950321,260165870,605349502
Ranthambore,Kanha,Ranthambore-Kanha,BEN_NW24,BEN_CI18,273167665,201087328,36708838,72080337,164378490,27866065,1159641386,1113494396,46146990,301627698,811866698,531335982,416398696,114937286,280261230,136137466
Ranthambore,Kanha,Ranthambore-Kanha,BEN_NW24,BEN_CI19,199098716,130994774,8727522,68103942,122267252,8727522,1159641386,1113494396,46146990,301627698,811866698,370653731,261143653,109510078,241812071,19331582
Ranthambore,Kanha,Ranthambore-Kanha,BEN_NW24,BEN_CI3,320032094,247598275,76614080,72433819,170984195,34546711,1159641386,1113494396,46146990,301627698,811866698,399948004,398407865,1540139,114426239,283981626
Ranthambore,Kanha,Ranthambore-Kanha,BEN_NW24,BEN_CI4,315809994,261496631,94619649,54313363,166876982,38240633,1159641386,1113494396,46146990,301627698,811866698,588039664,506748544,81291120,270707157,236041387
Ranthambore,Kanha,Ranthambore-Kanha,BEN_NW24,BEN_CI5,232332584,176118697,28257982,56213887,147860715,12043879,1159641386,1113494396,46146990,301627698,811866698,447217937,358814659,88403278,289122614,69692045
Ranthambore,Kanha,Ranthambore-Kanha,BEN_NW24,BEN_CI6,282559302,215173547,50863766,67385755,164309781,29419952,1159641386,1113494396,46146990,301627698,811866698,558093435,456569955,101523480,304633087,151936868
Ranthambore,Kanha,Ranthambore-Kanha,BEN_NW24,BEN_CI7,405748714,381661396,202157452,24087318,179503944,85900036,1159641386,1113494396,46146990,301627698,811866698,746271387,730520258,15751129,197580294,532939964
Ranthambore,Kanha,Ranthambore-Kanha,BEN_NW3,BEN_CI15,299485694,223542193,33529317,75943501,190012876,22108745,1280728709,1240123254,40605455,207797688,1032325566,558426844,440368350,118058494,313676252,126692098
Ranthambore,Kanha,Ranthambore-Kanha,BEN_NW3,BEN_CI16,511117742,450240910,242970318,60876832,207270592,59764160,1280728709,1240123254,40605455,207797688,1032325566,941465693,865515372,75950321,260165870,605349502
Ranthambore,Kanha,Ranthambore-Kanha,BEN_NW3,BEN_CI18,317453126,245636128,81843427,71816998,163792701,36851545,1280728709,1240123254,40605455,207797688,1032325566,531335982,416398696,114937286,280261230,136137466
Ranthambore,Kanha,Ranthambore-Kanha,BEN_NW3,BEN_CI19,211940627,139498250,4948668,72442377,134549582,4948668,1280728709,1240123254,40605455,207797688,1032325566,370653731,261143653,109510078,241812071,19331582
Ranthambore,Kanha,Ranthambore-Kanha,BEN_NW3,BEN_CI3,357011863,282931531,101305971,74080332,181625560,38481243,1280728709,1240123254,40605455,207797688,1032325566,399948004,398407865,1540139,114426239,283981626
Ranthambore,Kanha,Ranthambore-Kanha,BEN_NW3,BEN_CI4,339235778,282655466,110137272,56580312,172518194,42141452,1280728709,1240123254,40605455,207797688,1032325566,588039664,506748544,81291120,270707157,236041387
Ranthambore,Kanha,Ranthambore-Kanha,BEN_NW3,BEN_CI5,258838436,199436525,39934694,59401911,159501831,20992975,1280728709,1240123254,40605455,207797688,1032325566,447217937,358814659,88403278,289122614,69692045
Ranthambore,Kanha,Ranthambore-Kanha,BEN_NW3,BEN_CI6,310909978,242065015,59910433,68844963,182154582,31714631,1280728709,1240123254,40605455,207797688,1032325566,558093435,456569955,101523480,304633087,151936868
Ranthambore,Kanha,Ranthambore-Kanha,BEN_NW3,BEN_CI7,390928643,367578684,197756936,23349959,169821748,58079565,1280728709,1240123254,40605455,207797688,1032325566,746271387,730520258,15751129,197580294,532939964
Ranthambore,Kanha,Ranthambore-Kanha,BEN_NW4,BEN_CI15,318929549,249390020,71964642,69539529,177425378,33207209,1219365724,1186222475,33143249,158691252,1027531223,558426844,440368350,118058494,313676252,126692098
Ranthambore,Kanha,Ranthambore-Kanha,BEN_NW4,BEN_CI16,503808011,451063768,256677035,52744243,194386733,82811409,1219365724,1186222475,33143249,158691252,1027531223,941465693,865515372,75950321,260165870,605349502
Ranthambore,Kanha,Ranthambore-Kanha,BEN_NW4,BEN_CI18,301645855,234579891,84828906,67065964,149750985,34984008,1219365724,1186222475,33143249,158691252,1027531223,531335982,416398696,114937286,280261230,136137466
Ranthambore,Kanha,Ranthambore-Kanha,BEN_NW4,BEN_CI19,208091436,141760646,9054937,66330790,132705709,9054937,1219365724,1186222475,33143249,158691252,1027531223,370653731,261143653,109510078,241812071,19331582
Ranthambore,Kanha,Ranthambore-Kanha,BEN_NW4,BEN_CI3,361021198,295459677,123001557,65561521,172458120,44524178,1219365724,1186222475,33143249,158691252,1027531223,399948004,398407865,1540139,114426239,283981626
Ranthambore,Kanha,Ranthambore-Kanha,BEN_NW4,BEN_CI4,326552518,275546680,110197805,51005838,165348875,34335063,1219365724,1186222475,33143249,158691252,1027531223,588039664,506748544,81291120,270707157,236041387
Ranthambore,Kanha,Ranthambore-Kanha,BEN_NW4,BEN_CI5,244786304,190674065,25337245,54112239,165336820,20353288,1219365724,1186222475,33143249,158691252,1027531223,447217937,358814659,88403278,289122614,69692045
Ranthambore,Kanha,Ranthambore-Kanha,BEN_NW4,BEN_CI6,296789596,231391150,62901116,65398446,168490034,25267808,1219365724,1186222475,33143249,158691252,1027531223,558093435,456569955,101523480,304633087,151936868
Ranthambore,Kanha,Ranthambore-Kanha,BEN_NW4,BEN_CI7,384910166,362455031,215248326,22455135,147206705,42983408,1219365724,1186222475,33143249,158691252,1027531223,746271387,730520258,15751129,197580294,532939964
Ranthambore,Kanha,Ranthambore-Kanha,BEN_NW5,BEN_CI15,253592164,186364315,43758209,67227849,142606106,20167903,977809134,918585062,59224072,241966240,676618822,558426844,440368350,118058494,313676252,126692098
Ranthambore,Kanha,Ranthambore-Kanha,BEN_NW5,BEN_CI16,393198671,336651156,157911909,56547515,178739247,62271086,977809134,918585062,59224072,241966240,676618822,941465693,865515372,75950321,260165870,605349502
Ranthambore,Kanha,Ranthambore-Kanha,BEN_NW5,BEN_CI18,235981233,173150654,44164402,62830579,128986252,25745786,977809134,918585062,59224072,241966240,676618822,531335982,416398696,114937286,280261230,136137466
Ranthambore,Kanha,Ranthambore-Kanha,BEN_NW5,BEN_CI19,160513361,100152863,6398352,60360498,93754511,6398352,977809134,918585062,59224072,241966240,676618822,370653731,261143653,109510078,241812071,19331582
Ranthambore,Kanha,Ranthambore-Kanha,BEN_NW5,BEN_CI3,274587260,212308196,74019577,62279064,138288619,35074122,977809134,918585062,59224072,241966240,676618822,399948004,398407865,1540139,114426239,283981626
Ranthambore,Kanha,Ranthambore-Kanha,BEN_NW5,BEN_CI4,255236094,202446548,66127268,52789546,136319280,23670516,977809134,918585062,59224072,241966240,676618822,588039664,506748544,81291120,270707157,236041387
Ranthambore,Kanha,Ranthambore-Kanha,BEN_NW5,BEN_CI5,194694162,143194670,22609387,51499492,120585283,11356379,977809134,918585062,59224072,241966240,676618822,447217937,358814659,88403278,289122614,69692045
Ranthambore,Kanha,Ranthambore-Kanha,BEN_NW5,BEN_CI6,255046833,195956153,48655322,59090680,147300831,25720269,977809134,918585062,59224072,241966240,676618822,558093435,456569955,101523480,304633087,151936868
Ranthambore,Kanha,Ranthambore-Kanha,BEN_NW5,BEN_CI7,323768709,297497259,152950918,26271450,144546341,41655860,977809134,918585062,59224072,241966240,676618822,746271387,730520258,15751129,197580294,532939964
Ranthambore,Kanha,Ranthambore-Kanha,BEN_NW55,BEN_CI15,283806229,205785211,29740856,78021018,176044355,27097228,1131174741,1073214798,57959943,534097691,539117107,558426844,440368350,118058494,313676252,126692098
Ranthambore,Kanha,Ranthambore-Kanha,BEN_NW55,BEN_CI16,477020002,412267129,151733733,64752873,260533396,98111639,1131174741,1073214798,57959943,534097691,539117107,941465693,865515372,75950321,260165870,605349502
Ranthambore,Kanha,Ranthambore-Kanha,BEN_NW55,BEN_CI18,262918829,188330000,22338922,74588829,165991078,19335231,1131174741,1073214798,57959943,534097691,539117107,531335982,416398696,114937286,280261230,136137466
Ranthambore,Kanha,Ranthambore-Kanha,BEN_NW55,BEN_CI19,192719814,127539836,2477976,65179978,125061860,2477976,1131174741,1073214798,57959943,534097691,539117107,370653731,261143653,109510078,241812071,19331582
Ranthambore,Kanha,Ranthambore-Kanha,BEN_NW55,BEN_CI3,313928239,239126792,50933422,74801447,188193370,33695872,1131174741,1073214798,57959943,534097691,539117107,399948004,398407865,1540139,114426239,283981626
Ranthambore,Kanha,Ranthambore-Kanha,BEN_NW55,BEN_CI4,282501816,224522347,40664251,57979469,183858096,23904366,1131174741,1073214798,57959943,534097691,539117107,588039664,506748544,81291120,270707157,236041387
Ranthambore,Kanha,Ranthambore-Kanha,BEN_NW55,BEN_CI5,219793296,160286419,19865193,59506877,140421226,11097252,1131174741,1073214798,57959943,534097691,539117107,447217937,358814659,88403278,289122614,69692045
Ranthambore,Kanha,Ranthambore-Kanha,BEN_NW55,BEN_CI6,286267332,215262616,36885972,71004716,178376644,27262815,1131174741,1073214798,57959943,534097691,539117107,558093435,456569955,101523480,304633087,151936868
Ranthambore,Kanha,Ranthambore-Kanha,BEN_NW55,BEN_CI7,369078253,343423093,123731770,25655160,219691323,66667594,1131174741,1073214798,57959943,534097691,539117107,746271387,730520258,15751129,197580294,532939964
Ranthambore,Kanha,Ranthambore-Kanha,BEN_NW57,BEN_CI15,295750116,207241655,19801912,88508461,187439743,17302457,1180288036,1103120235,77167801,638361097,464759138,558426844,440368350,118058494,313676252,126692098
Ranthambore,Kanha,Ranthambore-Kanha,BEN_NW57,BEN_CI16,473374923,396517101,117366237,76857822,279150864,75182042,1180288036,1103120235,77167801,638361097,464759138,941465693,865515372,75950321,260165870,605349502
Ranthambore,Kanha,Ranthambore-Kanha,BEN_NW57,BEN_CI18,281628142,194201281,17272649,87426861,176928632,13348774,1180288036,1103120235,77167801,638361097,464759138,531335982,416398696,114937286,280261230,136137466
Ranthambore,Kanha,Ranthambore-Kanha,BEN_NW57,BEN_CI19,202523169,131148037,5876408,71375132,125271629,5876408,1180288036,1103120235,77167801,638361097,464759138,370653731,261143653,109510078,241812071,19331582
Ranthambore,Kanha,Ranthambore-Kanha,BEN_NW57,BEN_CI3,322550304,234428253,34957499,88122051,199470754,29476449,1180288036,1103120235,77167801,638361097,464759138,399948004,398407865,1540139,114426239,283981626
Ranthambore,Kanha,Ranthambore-Kanha,BEN_NW57,BEN_CI4,302243609,231860971,34714839,70382638,197146132,32407984,1180288036,1103120235,77167801,638361097,464759138,588039664,506748544,81291120,270707157,236041387
Ranthambore,Kanha,Ranthambore-Kanha,BEN_NW57,BEN_CI5,228131817,158417567,13851546,69714250,144566021,6422720,1180288036,1103120235,77167801,638361097,464759138,447217937,358814659,88403278,289122614,69692045
Ranthambore,Kanha,Ranthambore-Kanha,BEN_NW57,BEN_CI6,323026368,243447235,40766449,79579133,202680786,27456973,1180288036,1103120235,77167801,638361097,464759138,558093435,456569955,101523480,304633087,151936868
Ranthambore,Kanha,Ranthambore-Kanha,BEN_NW57,BEN_CI7,385822018,349503916,106150514,36318102,243353402,73346752,1180288036,1103120235,77167801,638361097,464759138,746271387,730520258,15751129,197580294,532939964
Ranthambore,Kanha,Ranthambore-Kanha,BEN_NW6,BEN_CI15,244383603,179976621,42183268,64406982,137793353,25090614,992143483,946435718,45707765,248527765,697907953,558426844,440368350,118058494,313676252,126692098
Ranthambore,Kanha,Ranthambore-Kanha,BEN_NW6,BEN_CI16,413616671,361979725,182528546,51636946,179451179,59232063,992143483,946435718,45707765,248527765,697907953,941465693,865515372,75950321,260165870,605349502
Ranthambore,Kanha,Ranthambore-Kanha,BEN_NW6,BEN_CI18,233915018,170298615,32911858,63616403,137386757,15389045,992143483,946435718,45707765,248527765,697907953,531335982,416398696,114937286,280261230,136137466
Ranthambore,Kanha,Ranthambore-Kanha,BEN_NW6,BEN_CI19,160604964,103291040,1355019,57313924,101936021,1355019,992143483,946435718,45707765,248527765,697907953,370653731,261143653,109510078,241812071,19331582
Ranthambore,Kanha,Ranthambore-Kanha,BEN_NW6,BEN_CI3,287114547,226388727,90966575,60725820,135422152,34453691,992143483,946435718,45707765,248527765,697907953,399948004,398407865,1540139,114426239,283981626
Ranthambore,Kanha,Ranthambore-Kanha,BEN_NW6,BEN_CI4,257948578,211409968,58250803,46538610,153159165,21727958,992143483,946435718,45707765,248527765,697907953,588039664,506748544,81291120,270707157,236041387
Ranthambore,Kanha,Ranthambore-Kanha,BEN_NW6,BEN_CI5,207140128,159520626,25872395,47619502,133648231,13256646,992143483,946435718,45707765,248527765,697907953,447217937,358814659,88403278,289122614,69692045
Ranthambore,Kanha,Ranthambore-Kanha,BEN_NW6,BEN_CI6,254815494,198641694,48006194,56173800,150635500,20988761,992143483,946435718,45707765,248527765,697907953,558093435,456569955,101523480,304633087,151936868
Ranthambore,Kanha,Ranthambore-Kanha,BEN_NW6,BEN_CI7,349462621,327911566,198070005,21551055,129841561,49868499,992143483,946435718,45707765,248527765,697907953,746271387,730520258,15751129,197580294,532939964
Ranthambore,Kanha,Ranthambore-Kanha,BEN_NW8,BEN_CI15,309816228,235772704,56838171,74043524,178934533,32451814,1196839698,1156984240,39855458,275076038,881908202,558426844,440368350,118058494,313676252,126692098
Ranthambore,Kanha,Ranthambore-Kanha,BEN_NW8,BEN_CI16,494052158,435904311,207538738,58147847,228365573,98341114,1196839698,1156984240,39855458,275076038,881908202,941465693,865515372,75950321,260165870,605349502
Ranthambore,Kanha,Ranthambore-Kanha,BEN_NW8,BEN_CI18,297006677,224710871,62232734,72295806,162478137,41002801,1196839698,1156984240,39855458,275076038,881908202,531335982,416398696,114937286,280261230,136137466
Ranthambore,Kanha,Ranthambore-Kanha,BEN_NW8,BEN_CI19,198419777,132834682,6206286,65585095,126628396,6206286,1196839698,1156984240,39855458,275076038,881908202,370653731,261143653,109510078,241812071,19331582
Ranthambore,Kanha,Ranthambore-Kanha,BEN_NW8,BEN_CI3,323532270,252516314,79124499,71015956,173391815,36486319,1196839698,1156984240,39855458,275076038,881908202,399948004,398407865,1540139,114426239,283981626
Ranthambore,Kanha,Ranthambore-Kanha,BEN_NW8,BEN_CI4,292362070,235950024,57481752,56412046,178468272,22450330,1196839698,1156984240,39855458,275076038,881908202,588039664,506748544,81291120,270707157,236041387
Ranthambore,Kanha,Ranthambore-Kanha,BEN_NW8,BEN_CI5,232398795,178539166,19182729,53859629,159356437,15054416,1196839698,1156984240,39855458,275076038,881908202,447217937,358814659,88403278,289122614,69692045
Ranthambore,Kanha,Ranthambore-Kanha,BEN_NW8,BEN_CI6,288481675,221798691,47242131,66682984,174556560,34236864,1196839698,1156984240,39855458,275076038,881908202,558093435,456569955,101523480,304633087,151936868
Ranthambore,Kanha,Ranthambore-Kanha,BEN_NW8,BEN_CI7,408597406,383738734,216004467,24858672,167734267,76076801,1196839698,1156984240,39855458,275076038,881908202,746271387,730520258,15751129,197580294,532939964
Ranthambore,Kanha,Ranthambore-Kanha,BEN_NW9,BEN_CI15,317904197,244605861,60217593,73298336,184388268,36886307,1246521228,1203200533,43320695,216389572,986810961,558426844,440368350,118058494,313676252,126692098
Ranthambore,Kanha,Ranthambore-Kanha,BEN_NW9,BEN_CI16,534287143,475357326,279024157,58929817,196333169,73797435,1246521228,1203200533,43320695,216389572,986810961,941465693,865515372,75950321,260165870,605349502
Ranthambore,Kanha,Ranthambore-Kanha,BEN_NW9,BEN_CI18,291697006,215204022,62522297,76492984,152681725,33460604,1246521228,1203200533,43320695,216389572,986810961,531335982,416398696,114937286,280261230,136137466
Ranthambore,Kanha,Ranthambore-Kanha,BEN_NW9,BEN_CI19,192985865,125965821,10599283,67020044,115366538,10599283,1246521228,1203200533,43320695,216389572,986810961,370653731,261143653,109510078,241812071,19331582
Ranthambore,Kanha,Ranthambore-Kanha,BEN_NW9,BEN_CI3,365334155,291597928,123268597,73736227,168329331,38695861,1246521228,1203200533,43320695,216389572,986810961,399948004,398407865,1540139,114426239,283981626
Ranthambore,Kanha,Ranthambore-Kanha,BEN_NW9,BEN_CI4,339167520,284616734,120750093,54550786,163866641,37951077,1246521228,1203200533,43320695,216389572,986810961,588039664,506748544,81291120,270707157,236041387
Ranthambore,Kanha,Ranthambore-Kanha,BEN_NW9,BEN_CI5,258821358,202066296,26313369,56755062,175752927,18752454,1246521228,1203200533,43320695,216389572,986810961,447217937,358814659,88403278,289122614,69692045
Ranthambore,Kanha,Ranthambore-Kanha,BEN_NW9,BEN_CI6,312443690,244823662,68705002,67620028,176118660,36593178,1246521228,1203200533,43320695,216389572,986810961,558093435,456569955,101523480,304633087,151936868
Ranthambore,Kanha,Ranthambore-Kanha,BEN_NW9,BEN_CI7,428221421,405647082,244139159,22574339,161507923,63080695,1246521228,1203200533,43320695,216389572,986810961,746271387,730520258,15751129,197580294,532939964
Ranthambore,Kaziranga,Ranthambore-Kaziranga,BEN_NW10,BEN_NE1,308824152,218995950,48704459,89828202,170291491,27714390,1266198710,1229664069,36534641,328923565,900740504,560246780,423100976,137145804,256700947,166400029
Ranthambore,Kaziranga,Ranthambore-Kaziranga,BEN_NW10,BEN_NE2,690935769,622420812,342724869,68514957,279695943,162942701,1266198710,1229664069,36534641,328923565,900740504,1250511108,1174630426,75880682,233913209,940717217
Ranthambore,Kaziranga,Ranthambore-Kaziranga,BEN_NW10,BEN_NE3,579035566,519428626,279134658,59606940,240293968,146289124,1266198710,1229664069,36534641,328923565,900740504,1008859852,937520336,71339516,277485474,660034862
Ranthambore,Kaziranga,Ranthambore-Kaziranga,BEN_NW11,BEN_NE1,248564776,174097232,37369527,74467544,136727705,11079563,997123987,950413379,46710608,263905963,686507416,560246780,423100976,137145804,256700947,166400029
Ranthambore,Kaziranga,Ranthambore-Kaziranga,BEN_NW11,BEN_NE2,558281397,497148769,271430335,61132628,225718434,119144494,997123987,950413379,46710608,263905963,686507416,1250511108,1174630426,75880682,233913209,940717217
Ranthambore,Kaziranga,Ranthambore-Kaziranga,BEN_NW11,BEN_NE3,461916200,408373983,199624625,53542217,208749358,101135680,997123987,950413379,46710608,263905963,686507416,1008859852,937520336,71339516,277485474,660034862
Ranthambore,Kaziranga,Ranthambore-Kaziranga,BEN_NW12,BEN_NE1,321502401,236852160,70250724,84650241,166601436,30005778,1267506856,1231795407,35711449,227052846,1004742561,560246780,423100976,137145804,256700947,166400029
Ranthambore,Kaziranga,Ranthambore-Kaziranga,BEN_NW12,BEN_NE2,685722706,620259676,374370887,65463030,245888789,118970795,1267506856,1231795407,35711449,227052846,1004742561,1250511108,1174630426,75880682,233913209,940717217
Ranthambore,Kaziranga,Ranthambore-Kaziranga,BEN_NW12,BEN_NE3,578582186,523685950,292420584,54896236,231265366,116148259,1267506856,1231795407,35711449,227052846,1004742561,1008859852,937520336,71339516,277485474,660034862
Ranthambore,Kaziranga,Ranthambore-Kaziranga,BEN_NW13,BEN_NE1,295564593,211276575,54265168,84288018,157011407,27747808,1183131254,1138285233,44846021,344174628,794110605,560246780,423100976,137145804,256700947,166400029
Ranthambore,Kaziranga,Ranthambore-Kaziranga,BEN_NW13,BEN_NE2,632932416,561236695,285961190,71695721,275275505,133751426,1183131254,1138285233,44846021,344174628,794110605,1250511108,1174630426,75880682,233913209,940717217
Ranthambore,Kaziranga,Ranthambore-Kaziranga,BEN_NW13,BEN_NE3,532101830,470524285,218930527,61577545,251593758,120706042,1183131254,1138285233,44846021,344174628,794110605,1008859852,937520336,71339516,277485474,660034862
Ranthambore,Kaziranga,Ranthambore-Kaziranga,BEN_NW14,BEN_NE1,317937131,234872146,85917884,83064985,148954262,28949525,1235716540,1190952996,44763544,177541519,1013411477,560246780,423100976,137145804,256700947,166400029
Ranthambore,Kaziranga,Ranthambore-Kaziranga,BEN_NW14,BEN_NE2,691782074,621610873,409747236,70171201,211863637,122405961,1235716540,1190952996,44763544,177541519,1013411477,1250511108,1174630426,75880682,233913209,940717217
Ranthambore,Kaziranga,Ranthambore-Kaziranga,BEN_NW14,BEN_NE3,574814717,513850651,307698490,60964066,206152161,107343245,1235716540,1190952996,44763544,177541519,1013411477,1008859852,937520336,71339516,277485474,660034862
Ranthambore,Kaziranga,Ranthambore-Kaziranga,BEN_NW17,BEN_NE1,279794656,201226870,55296008,78567786,145930862,25125119,1116321554,1085802823,30518731,256140006,829662817,560246780,423100976,137145804,256700947,166400029
Ranthambore,Kaziranga,Ranthambore-Kaziranga,BEN_NW17,BEN_NE2,635800265,578095991,343436593,57704274,234659398,122657429,1116321554,1085802823,30518731,256140006,829662817,1250511108,1174630426,75880682,233913209,940717217
Ranthambore,Kaziranga,Ranthambore-Kaziranga,BEN_NW17,BEN_NE3,531670700,481201769,287288161,50468931,193913608,107555909,1116321554,1085802823,30518731,256140006,829662817,1008859852,937520336,71339516,277485474,660034862
Ranthambore,Kaziranga,Ranthambore-Kaziranga,BEN_NW18,BEN_NE1,332804437,242159616,72630974,90644821,169528642,34722130,1339364699,1300736006,38628693,242877521,1057858485,560246780,423100976,137145804,256700947,166400029
Ranthambore,Kaziranga,Ranthambore-Kaziranga,BEN_NW18,BEN_NE2,769563816,706763014,464666954,62800802,242096060,149182189,1339364699,1300736006,38628693,242877521,1057858485,1250511108,1174630426,75880682,233913209,940717217
Ranthambore,Kaziranga,Ranthambore-Kaziranga,BEN_NW18,BEN_NE3,609219580,548328153,308586514,60891427,239741639,128375475,1339364699,1300736006,38628693,242877521,1057858485,1008859852,937520336,71339516,277485474,660034862
Ranthambore,Kaziranga,Ranthambore-Kaziranga,BEN_NW19,BEN_NE1,277734648,201158914,72637366,76575734,128521548,27635921,1081768306,1036331080,45437226,232322355,804008725,560246780,423100976,137145804,256700947,166400029
Ranthambore,Kaziranga,Ranthambore-Kaziranga,BEN_NW19,BEN_NE2,567476209,499897748,284434749,67578461,215462999,80498039,1081768306,1036331080,45437226,232322355,804008725,1250511108,1174630426,75880682,233913209,940717217
Ranthambore,Kaziranga,Ranthambore-Kaziranga,BEN_NW19,BEN_NE3,488947825,429053745,233842154,59894080,195211591,102504522,1081768306,1036331080,45437226,232322355,804008725,1008859852,937520336,71339516,277485474,660034862
Ranthambore,Kaziranga,Ranthambore-Kaziranga,BEN_NW20,BEN_NE1,281470184,195816961,34110898,85653223,161706063,15699823,1086271749,1022278981,63992768,541693814,480585167,560246780,423100976,137145804,256700947,166400029
Ranthambore,Kaziranga,Ranthambore-Kaziranga,BEN_NW20,BEN_NE2,575212439,498930400,146532008,76282039,352398392,113424419,1086271749,1022278981,63992768,541693814,480585167,1250511108,1174630426,75880682,233913209,940717217
Ranthambore,Kaziranga,Ranthambore-Kaziranga,BEN_NW20,BEN_NE3,476749826,409761325,121446727,66988501,288314598,92901301,1086271749,1022278981,63992768,541693814,480585167,1008859852,937520336,71339516,277485474,660034862
Ranthambore,Kaziranga,Ranthambore-Kaziranga,BEN_NW24,BEN_NE1,271530202,185979141,33878580,85551061,152100561,31656549,1159641386,1113494396,46146990,301627698,811866698,560246780,423100976,137145804,256700947,166400029
Ranthambore,Kaziranga,Ranthambore-Kaziranga,BEN_NW24,BEN_NE2,651135574,583837967,329703509,67297607,254134458,160676175,1159641386,1113494396,46146990,301627698,811866698,1250511108,1174630426,75880682,233913209,940717217
Ranthambore,Kaziranga,Ranthambore-Kaziranga,BEN_NW24,BEN_NE3,529095209,467750547,212319426,61344662,255431121,132283491,1159641386,1113494396,46146990,301627698,811866698,1008859852,937520336,71339516,277485474,660034862
Ranthambore,Kaziranga,Ranthambore-Kaziranga,BEN_NW3,BEN_NE1,311632159,222385955,61730722,89246204,160655233,22494413,1280728709,1240123254,40605455,207797688,1032325566,560246780,423100976,137145804,256700947,166400029
Ranthambore,Kaziranga,Ranthambore-Kaziranga,BEN_NW3,BEN_NE2,701662777,634474451,415324758,67188326,219149693,102153742,1280728709,1240123254,40605455,207797688,1032325566,1250511108,1174630426,75880682,233913209,940717217
Ranthambore,Kaziranga,Ranthambore-Kaziranga,BEN_NW3,BEN_NE3,593674616,533644501,313846676,60030115,219797825,94636415,1280728709,1240123254,40605455,207797688,1032325566,1008859852,937520336,71339516,277485474,660034862
Ranthambore,Kaziranga,Ranthambore-Kaziranga,BEN_NW4,BEN_NE1,306762303,228470633,85089524,78291670,143381109,30100703,1219365724,1186222475,33143249,158691252,1027531223,560246780,423100976,137145804,256700947,166400029
Ranthambore,Kaziranga,Ranthambore-Kaziranga,BEN_NW4,BEN_NE2,649958236,588939198,390895691,61019038,198043507,94083506,1219365724,1186222475,33143249,158691252,1027531223,1250511108,1174630426,75880682,233913209,940717217
Ranthambore,Kaziranga,Ranthambore-Kaziranga,BEN_NW4,BEN_NE3,508762173,451377183,256084298,57384990,195292885,94900731,1219365724,1186222475,33143249,158691252,1027531223,1008859852,937520336,71339516,277485474,660034862
Ranthambore,Kaziranga,Ranthambore-Kaziranga,BEN_NW5,BEN_NE1,247193395,175933408,48519710,71259987,127413698,18752039,977809134,918585062,59224072,241966240,676618822,560246780,423100976,137145804,256700947,166400029
Ranthambore,Kaziranga,Ranthambore-Kaziranga,BEN_NW5,BEN_NE2,531062560,465549618,256254227,65512942,209295391,108502266,977809134,918585062,59224072,241966240,676618822,1250511108,1174630426,75880682,233913209,940717217
Ranthambore,Kaziranga,Ranthambore-Kaziranga,BEN_NW5,BEN_NE3,450931192,390188172,199957778,60743020,190230394,87179331,977809134,918585062,59224072,241966240,676618822,1008859852,937520336,71339516,277485474,660034862
Ranthambore,Kaziranga,Ranthambore-Kaziranga,BEN_NW55,BEN_NE1,277517373,190912444,35241655,86604929,155670789,22643276,1131174741,1073214798,57959943,534097691,539117107,560246780,423100976,137145804,256700947,166400029
Ranthambore,Kaziranga,Ranthambore-Kaziranga,BEN_NW55,BEN_NE2,601103016,522289195,199828709,78813821,322460486,119629599,1131174741,1073214798,57959943,534097691,539117107,1250511108,1174630426,75880682,233913209,940717217
Ranthambore,Kaziranga,Ranthambore-Kaziranga,BEN_NW55,BEN_NE3,509072138,440130477,144524725,68941661,295605752,92287529,1131174741,1073214798,57959943,534097691,539117107,1008859852,937520336,71339516,277485474,660034862
Ranthambore,Kaziranga,Ranthambore-Kaziranga,BEN_NW57,BEN_NE1,304952525,206758594,40068231,98193931,166690363,27764367,1180288036,1103120235,77167801,638361097,464759138,560246780,423100976,137145804,256700947,166400029
Ranthambore,Kaziranga,Ranthambore-Kaziranga,BEN_NW57,BEN_NE2,694961084,610573888,212609433,84387196,397964455,137291093,1180288036,1103120235,77167801,638361097,464759138,1250511108,1174630426,75880682,233913209,940717217
Ranthambore,Kaziranga,Ranthambore-Kaziranga,BEN_NW57,BEN_NE3,540582507,463190588,131564119,77391919,331626469,84632428,1180288036,1103120235,77167801,638361097,464759138,1008859852,937520336,71339516,277485474,660034862
Ranthambore,Kaziranga,Ranthambore-Kaziranga,BEN_NW6,BEN_NE1,251055609,175980460,43874951,75075149,132105509,22958884,992143483,946435718,45707765,248527765,697907953,560246780,423100976,137145804,256700947,166400029
Ranthambore,Kaziranga,Ranthambore-Kaziranga,BEN_NW6,BEN_NE2,535326399,471992448,258716320,63333951,213276128,109330689,992143483,946435718,45707765,248527765,697907953,1250511108,1174630426,75880682,233913209,940717217
Ranthambore,Kaziranga,Ranthambore-Kaziranga,BEN_NW6,BEN_NE3,457093927,402588389,216240014,54505538,186348375,100472554,992143483,946435718,45707765,248527765,697907953,1008859852,937520336,71339516,277485474,660034862
Ranthambore,Kaziranga,Ranthambore-Kaziranga,BEN_NW8,BEN_NE1,305074413,221318390,65797102,83756023,155521288,23448888,1196839698,1156984240,39855458,275076038,881908202,560246780,423100976,137145804,256700947,166400029
Ranthambore,Kaziranga,Ranthambore-Kaziranga,BEN_NW8,BEN_NE2,659115193,595171586,332545288,63943607,262626298,121314601,1196839698,1156984240,39855458,275076038,881908202,1250511108,1174630426,75880682,233913209,940717217
Ranthambore,Kaziranga,Ranthambore-Kaziranga,BEN_NW8,BEN_NE3,535398639,477296649,242582185,58101990,234714464,125293224,1196839698,1156984240,39855458,275076038,881908202,1008859852,937520336,71339516,277485474,660034862
Ranthambore,Kaziranga,Ranthambore-Kaziranga,BEN_NW9,BEN_NE1,315683760,231306540,74715098,84377220,156591442,23034631,1246521228,1203200533,43320695,216389572,986810961,560246780,423100976,137145804,256700947,166400029
Ranthambore,Kaziranga,Ranthambore-Kaziranga,BEN_NW9,BEN_NE2,653448297,581968228,354794085,71480069,227174143,101341573,1246521228,1203200533,43320695,216389572,986810961,1250511108,1174630426,75880682,233913209,940717217
Ranthambore,Kaziranga,Ranthambore-Kaziranga,BEN_NW9,BEN_NE3,549435240,486365356,254955513,63069884,231409843,98483305,1246521228,1203200533,43320695,216389572,986810961,1008859852,937520336,71339516,277485474,660034862
Ranthambore,Lalgarh,Ranthambore-Lalgarh,BEN_NW10,LGS1,433235486,364283968,104336668,68951518,259947300,72646335,1266198710,1229664069,36534641,328923565,900740504,737843728,638009894,99833834,404772144,233237750
Ranthambore,Lalgarh,Ranthambore-Lalgarh,BEN_NW11,LGS1,321408920,257123429,79078130,64285491,178045299,48535731,997123987,950413379,46710608,263905963,686507416,737843728,638009894,99833834,404772144,233237750
Ranthambore,Lalgarh,Ranthambore-Lalgarh,BEN_NW12,LGS1,421408790,354124340,102684973,67284450,251439367,66245620,1267506856,1231795407,35711449,227052846,1004742561,737843728,638009894,99833834,404772144,233237750
Ranthambore,Lalgarh,Ranthambore-Lalgarh,BEN_NW13,LGS1,414315480,347460353,91137120,66855127,256323233,59518446,1183131254,1138285233,44846021,344174628,794110605,737843728,638009894,99833834,404772144,233237750
Ranthambore,Lalgarh,Ranthambore-Lalgarh,BEN_NW14,LGS1,404420479,333912357,91666619,70508122,242245738,58498619,1235716540,1190952996,44763544,177541519,1013411477,737843728,638009894,99833834,404772144,233237750
Ranthambore,Lalgarh,Ranthambore-Lalgarh,BEN_NW17,LGS1,366941381,304490183,75285852,62451198,229204331,50627112,1116321554,1085802823,30518731,256140006,829662817,737843728,638009894,99833834,404772144,233237750
Ranthambore,Lalgarh,Ranthambore-Lalgarh,BEN_NW18,LGS1,440567835,369843960,105653339,70723875,264190621,70947784,1339364699,1300736006,38628693,242877521,1057858485,737843728,638009894,99833834,404772144,233237750
Ranthambore,Lalgarh,Ranthambore-Lalgarh,BEN_NW19,LGS1,354442167,288431409,64510618,66010758,223920791,50998700,1081768306,1036331080,45437226,232322355,804008725,737843728,638009894,99833834,404772144,233237750
Ranthambore,Lalgarh,Ranthambore-Lalgarh,BEN_NW20,LGS1,384582732,315673649,81163299,68909083,234510350,48643028,1086271749,1022278981,63992768,541693814,480585167,737843728,638009894,99833834,404772144,233237750
Ranthambore,Lalgarh,Ranthambore-Lalgarh,BEN_NW24,LGS1,402226672,331230851,85089546,70995821,246141305,55224835,1159641386,1113494396,46146990,301627698,811866698,737843728,638009894,99833834,404772144,233237750
Ranthambore,Lalgarh,Ranthambore-Lalgarh,BEN_NW3,LGS1,423830678,351140983,113215225,72689695,237925758,67127098,1280728709,1240123254,40605455,207797688,1032325566,737843728,638009894,99833834,404772144,233237750
Ranthambore,Lalgarh,Ranthambore-Lalgarh,BEN_NW4,LGS1,407852936,346489254,104843516,61363682,241645738,57394869,1219365724,1186222475,33143249,158691252,1027531223,737843728,638009894,99833834,404772144,233237750
Ranthambore,Lalgarh,Ranthambore-Lalgarh,BEN_NW5,LGS1,312415268,245190689,52845792,67224579,192344897,31982866,977809134,918585062,59224072,241966240,676618822,737843728,638009894,99833834,404772144,233237750
Ranthambore,Lalgarh,Ranthambore-Lalgarh,BEN_NW55,LGS1,395168847,325222321,74430822,69946526,250791499,40895264,1131174741,1073214798,57959943,534097691,539117107,737843728,638009894,99833834,404772144,233237750
Ranthambore,Lalgarh,Ranthambore-Lalgarh,BEN_NW57,LGS1,389959788,310346723,68536980,79613065,241809743,47038753,1180288036,1103120235,77167801,638361097,464759138,737843728,638009894,99833834,404772144,233237750
Ranthambore,Lalgarh,Ranthambore-Lalgarh,BEN_NW6,LGS1,329208673,270644216,66821443,58564457,203822773,39831943,992143483,946435718,45707765,248527765,697907953,737843728,638009894,99833834,404772144,233237750
Ranthambore,Lalgarh,Ranthambore-Lalgarh,BEN_NW8,LGS1,375524078,307232565,72378406,68291513,234854159,42055417,1196839698,1156984240,39855458,275076038,881908202,737843728,638009894,99833834,404772144,233237750
Ranthambore,Lalgarh,Ranthambore-Lalgarh,BEN_NW9,LGS1,415353417,346145527,99893127,69207890,246252400,62528899,1246521228,1203200533,43320695,216389572,986810961,737843728,638009894,99833834,404772144,233237750
Ranthambore,Periyar,Ranthambore-Periyar,BEN_NW10,BEN_SI5,737666867,684384379,332641304,53282488,351743075,190268084,1266198710,1229664069,36534641,328923565,900740504,1343835283,1299687777,44147506,344660143,955027634
Ranthambore,Periyar,Ranthambore-Periyar,BEN_NW11,BEN_SI5,555238494,502725647,213595484,52512847,289130163,125656499,997123987,950413379,46710608,263905963,686507416,1343835283,1299687777,44147506,344660143,955027634
Ranthambore,Periyar,Ranthambore-Periyar,BEN_NW12,BEN_SI5,724251259,672713253,360727322,51538006,311985931,163593733,1267506856,1231795407,35711449,227052846,1004742561,1343835283,1299687777,44147506,344660143,955027634
Ranthambore,Periyar,Ranthambore-Periyar,BEN_NW13,BEN_SI5,691968370,636229142,293639374,55739228,342589768,185606746,1183131254,1138285233,44846021,344174628,794110605,1343835283,1299687777,44147506,344660143,955027634
Ranthambore,Periyar,Ranthambore-Periyar,BEN_NW14,BEN_SI5,713306385,657409469,378726421,55896916,278683048,169397982,1235716540,1190952996,44763544,177541519,1013411477,1343835283,1299687777,44147506,344660143,955027634
Ranthambore,Periyar,Ranthambore-Periyar,BEN_NW17,BEN_SI5,675277530,632347458,342169058,42930072,290178400,158683276,1116321554,1085802823,30518731,256140006,829662817,1343835283,1299687777,44147506,344660143,955027634
Ranthambore,Periyar,Ranthambore-Periyar,BEN_NW18,BEN_SI5,798375915,747528693,414682592,50847222,332846101,181180299,1339364699,1300736006,38628693,242877521,1057858485,1343835283,1299687777,44147506,344660143,955027634
Ranthambore,Periyar,Ranthambore-Periyar,BEN_NW19,BEN_SI5,660066569,608135338,325207147,51931231,282928191,133760230,1081768306,1036331080,45437226,232322355,804008725,1343835283,1299687777,44147506,344660143,955027634
Ranthambore,Periyar,Ranthambore-Periyar,BEN_NW20,BEN_SI5,650418584,583734481,188179512,66684103,395554969,127878494,1086271749,1022278981,63992768,541693814,480585167,1343835283,1299687777,44147506,344660143,955027634
Ranthambore,Periyar,Ranthambore-Periyar,BEN_NW24,BEN_SI5,675236559,615534085,301319174,59702474,314214911,168394690,1159641386,1113494396,46146990,301627698,811866698,1343835283,1299687777,44147506,344660143,955027634
Ranthambore,Periyar,Ranthambore-Periyar,BEN_NW3,BEN_SI5,813860645,763585427,471588714,50275218,291996713,213279125,1280728709,1240123254,40605455,207797688,1032325566,1343835283,1299687777,44147506,344660143,955027634
Ranthambore,Periyar,Ranthambore-Periyar,BEN_NW4,BEN_SI5,686973948,638575452,369639213,48398496,268936239,162901983,1219365724,1186222475,33143249,158691252,1027531223,1343835283,1299687777,44147506,344660143,955027634
Ranthambore,Periyar,Ranthambore-Periyar,BEN_NW5,BEN_SI5,586958483,531119194,275753390,55839289,255365804,130417833,977809134,918585062,59224072,241966240,676618822,1343835283,1299687777,44147506,344660143,955027634
Ranthambore,Periyar,Ranthambore-Periyar,BEN_NW55,BEN_SI5,657728758,594553809,185543599,63174949,409010210,136686718,1131174741,1073214798,57959943,534097691,539117107,1343835283,1299687777,44147506,344660143,955027634
Ranthambore,Periyar,Ranthambore-Periyar,BEN_NW57,BEN_SI5,693891453,608651986,167801037,85239467,440850949,125423135,1180288036,1103120235,77167801,638361097,464759138,1343835283,1299687777,44147506,344660143,955027634
Ranthambore,Periyar,Ranthambore-Periyar,BEN_NW6,BEN_SI5,586599654,538060425,280922328,48539229,257138097,135036313,992143483,946435718,45707765,248527765,697907953,1343835283,1299687777,44147506,344660143,955027634
Ranthambore,Periyar,Ranthambore-Periyar,BEN_NW8,BEN_SI5,705422579,655326596,324634250,50095983,330692346,171949339,1196839698,1156984240,39855458,275076038,881908202,1343835283,1299687777,44147506,344660143,955027634
Ranthambore,Periyar,Ranthambore-Periyar,BEN_NW9,BEN_SI5,714197574,656547913,350064849,57649661,306483064,161210909,1246521228,1203200533,43320695,216389572,986810961,1343835283,1299687777,44147506,344660143,955027634
Ranthambore,Ranthambore,Ranthambore-Ranthambore,BEN_NW10,BEN_NW11,630027681,586720489,316897425,43307192,269823064,155439092,1266198710,1229664069,36534641,328923565,900740504,997123987,950413379,46710608,263905963,686507416
Ranthambore,Ranthambore,Ranthambore-Ranthambore,BEN_NW10,BEN_NW12,842959703,803266277,493596144,39693426,309670133,215215378,1266198710,1229664069,36534641,328923565,900740504,1267506856,1231795407,35711449,227052846,1004742561
Ranthambore,Ranthambore,Ranthambore-Ranthambore,BEN_NW10,BEN_NW13,776735444,731149547,371912654,45585897,359236893,188540182,1266198710,1229664069,36534641,328923565,900740504,1183131254,1138285233,44846021,344174628,794110605
Ranthambore,Ranthambore,Ranthambore-Ranthambore,BEN_NW10,BEN_NW14,787398400,743098179,464374873,44300221,278723306,201160304,1266198710,1229664069,36534641,328923565,900740504,1235716540,1190952996,44763544,177541519,1013411477
Ranthambore,Ranthambore,Ranthambore-Ranthambore,BEN_NW10,BEN_NW17,679182990,642041942,369031954,37141048,273009988,180321309,1266198710,1229664069,36534641,328923565,900740504,1116321554,1085802823,30518731,256140006,829662817
Ranthambore,Ranthambore,Ranthambore-Ranthambore,BEN_NW10,BEN_NW18,869572738,829808913,526376170,39763825,303432743,217898065,1266198710,1229664069,36534641,328923565,900740504,1339364699,1300736006,38628693,242877521,1057858485
Ranthambore,Ranthambore,Ranthambore-Ranthambore,BEN_NW10,BEN_NW19,702571424,657269716,371664651,45301708,285605065,171213056,1266198710,1229664069,36534641,328923565,900740504,1081768306,1036331080,45437226,232322355,804008725
Ranthambore,Ranthambore,Ranthambore-Ranthambore,BEN_NW10,BEN_NW20,704639241,645680212,232848389,58959029,412831823,157642554,1266198710,1229664069,36534641,328923565,900740504,1086271749,1022278981,63992768,541693814,480585167
Ranthambore,Ranthambore,Ranthambore-Ranthambore,BEN_NW10,BEN_NW24,652408911,603414805,280066663,48994106,323348142,161413429,1266198710,1229664069,36534641,328923565,900740504,1159641386,1113494396,46146990,301627698,811866698
Ranthambore,Ranthambore,Ranthambore-Ranthambore,BEN_NW10,BEN_NW3,760754865,717205215,419229109,43549650,297976106,192598568,1266198710,1229664069,36534641,328923565,900740504,1280728709,1240123254,40605455,207797688,1032325566
Ranthambore,Ranthambore,Ranthambore-Ranthambore,BEN_NW10,BEN_NW4,764437292,727626566,452792346,36810726,274834220,190479179,1266198710,1229664069,36534641,328923565,900740504,1219365724,1186222475,33143249,158691252,1027531223
Ranthambore,Ranthambore,Ranthambore-Ranthambore,BEN_NW10,BEN_NW5,608066748,556378431,292790042,51688317,263588389,125466686,1266198710,1229664069,36534641,328923565,900740504,977809134,918585062,59224072,241966240,676618822
Ranthambore,Ranthambore,Ranthambore-Ranthambore,BEN_NW10,BEN_NW55,710145193,656948170,240023544,53197023,416924626,153134777,1266198710,1229664069,36534641,328923565,900740504,1131174741,1073214798,57959943,534097691,539117107
Ranthambore,Ranthambore,Ranthambore-Ranthambore,BEN_NW10,BEN_NW57,723198929,655225116,207556147,67973813,447668969,136611221,1266198710,1229664069,36534641,328923565,900740504,1180288036,1103120235,77167801,638361097,464759138
Ranthambore,Ranthambore,Ranthambore-Ranthambore,BEN_NW10,BEN_NW6,659034250,616225419,341389446,42808831,274835973,148742961,1266198710,1229664069,36534641,328923565,900740504,992143483,946435718,45707765,248527765,697907953
Ranthambore,Ranthambore,Ranthambore-Ranthambore,BEN_NW10,BEN_NW8,743193523,697603320,365451117,45590203,332152203,190978906,1266198710,1229664069,36534641,328923565,900740504,1196839698,1156984240,39855458,275076038,881908202
Ranthambore,Ranthambore,Ranthambore-Ranthambore,BEN_NW10,BEN_NW9,735863776,688612223,392743277,47251553,295868946,189880681,1266198710,1229664069,36534641,328923565,900740504,1246521228,1203200533,43320695,216389572,986810961
Ranthambore,Ranthambore,Ranthambore-Ranthambore,BEN_NW11,BEN_NW10,630027681,586720489,316897425,43307192,269823064,155439092,997123987,950413379,46710608,263905963,686507416,1266198710,1229664069,36534641,328923565,900740504
Ranthambore,Ranthambore,Ranthambore-Ranthambore,BEN_NW11,BEN_NW12,669523609,627220377,374525339,42303232,252695038,149569920,997123987,950413379,46710608,263905963,686507416,1267506856,1231795407,35711449,227052846,1004742561
Ranthambore,Ranthambore,Ranthambore-Ranthambore,BEN_NW11,BEN_NW13,628261209,583750182,305567410,44511027,278182772,121468806,997123987,950413379,46710608,263905963,686507416,1183131254,1138285233,44846021,344174628,794110605
Ranthambore,Ranthambore,Ranthambore-Ranthambore,BEN_NW11,BEN_NW14,686313559,641443754,420742406,44869805,220701348,124389819,997123987,950413379,46710608,263905963,686507416,1235716540,1190952996,44763544,177541519,1013411477
Ranthambore,Ranthambore,Ranthambore-Ranthambore,BEN_NW11,BEN_NW17,595078516,560721805,320287601,34356711,240434204,139190757,997123987,950413379,46710608,263905963,686507416,1116321554,1085802823,30518731,256140006,829662817
Ranthambore,Ranthambore,Ranthambore-Ranthambore,BEN_NW11,BEN_NW18,680386622,634689855,366417254,45696767,268272601,150181442,997123987,950413379,46710608,263905963,686507416,1339364699,1300736006,38628693,242877521,1057858485
Ranthambore,Ranthambore,Ranthambore-Ranthambore,BEN_NW11,BEN_NW19,584968410,541574790,308947363,43393620,232627427,122155235,997123987,950413379,46710608,263905963,686507416,1081768306,1036331080,45437226,232322355,804008725
Ranthambore,Ranthambore,Ranthambore-Ranthambore,BEN_NW11,BEN_NW20,572787769,515996307,197152874,56791462,318843433,112752171,997123987,950413379,46710608,263905963,686507416,1086271749,1022278981,63992768,541693814,480585167
Ranthambore,Ranthambore,Ranthambore-Ranthambore,BEN_NW11,BEN_NW24,562642257,514058880,248471615,48583377,265587265,125036883,997123987,950413379,46710608,263905963,686507416,1159641386,1113494396,46146990,301627698,811866698
Ranthambore,Ranthambore,Ranthambore-Ranthambore,BEN_NW11,BEN_NW3,601381431,556984350,313814837,44397081,243169513,123614321,997123987,950413379,46710608,263905963,686507416,1280728709,1240123254,40605455,207797688,1032325566
Ranthambore,Ranthambore,Ranthambore-Ranthambore,BEN_NW11,BEN_NW4,605851185,568308552,355861560,37542633,212446992,125611510,997123987,950413379,46710608,263905963,686507416,1219365724,1186222475,33143249,158691252,1027531223
Ranthambore,Ranthambore,Ranthambore-Ranthambore,BEN_NW11,BEN_NW5,565218417,519898038,306640941,45320379,213257097,95515600,997123987,950413379,46710608,263905963,686507416,977809134,918585062,59224072,241966240,676618822
Ranthambore,Ranthambore,Ranthambore-Ranthambore,BEN_NW11,BEN_NW55,630354706,579089524,246753348,51265182,332336176,136839768,997123987,950413379,46710608,263905963,686507416,1131174741,1073214798,57959943,534097691,539117107
Ranthambore,Ranthambore,Ranthambore-Ranthambore,BEN_NW11,BEN_NW57,620340196,560795480,175867369,59544716,384928111,99971196,997123987,950413379,46710608,263905963,686507416,1180288036,1103120235,77167801,638361097,464759138
Ranthambore,Ranthambore,Ranthambore-Ranthambore,BEN_NW11,BEN_NW6,541219990,499629009,268512907,41590981,231116102,105124031,997123987,950413379,46710608,263905963,686507416,992143483,946435718,45707765,248527765,697907953
Ranthambore,Ranthambore,Ranthambore-Ranthambore,BEN_NW11,BEN_NW8,626612664,581878545,295247413,44734119,286631132,126661848,997123987,950413379,46710608,263905963,686507416,1196839698,1156984240,39855458,275076038,881908202
Ranthambore,Ranthambore,Ranthambore-Ranthambore,BEN_NW11,BEN_NW9,677745531,631114174,373171037,46631357,257943137,147203927,997123987,950413379,46710608,263905963,686507416,1246521228,1203200533,43320695,216389572,986810961
Ranthambore,Ranthambore,Ranthambore-Ranthambore,BEN_NW12,BEN_NW10,842959703,803266277,493596144,39693426,309670133,215215378,1267506856,1231795407,35711449,227052846,1004742561,1266198710,1229664069,36534641,328923565,900740504
Ranthambore,Ranthambore,Ranthambore-Ranthambore,BEN_NW12,BEN_NW11,669523609,627220377,374525339,42303232,252695038,149569920,1267506856,1231795407,35711449,227052846,1004742561,997123987,950413379,46710608,263905963,686507416
Ranthambore,Ranthambore,Ranthambore-Ranthambore,BEN_NW12,BEN_NW13,814042835,769960363,434116806,44082472,335843557,183065823,1267506856,1231795407,35711449,227052846,1004742561,1183131254,1138285233,44846021,344174628,794110605
Ranthambore,Ranthambore,Ranthambore-Ranthambore,BEN_NW12,BEN_NW14,858268756,814342427,579142279,43926329,235200148,148030523,1267506856,1231795407,35711449,227052846,1004742561,1235716540,1190952996,44763544,177541519,1013411477
Ranthambore,Ranthambore,Ranthambore-Ranthambore,BEN_NW12,BEN_NW17,686036191,650847755,394512514,35188436,256335241,143313876,1267506856,1231795407,35711449,227052846,1004742561,1116321554,1085802823,30518731,256140006,829662817
Ranthambore,Ranthambore,Ranthambore-Ranthambore,BEN_NW12,BEN_NW18,827546478,785009837,512442277,42536641,272567560,157589214,1267506856,1231795407,35711449,227052846,1004742561,1339364699,1300736006,38628693,242877521,1057858485
Ranthambore,Ranthambore,Ranthambore-Ranthambore,BEN_NW12,BEN_NW19,694727591,649639220,403604670,45088371,246034550,131870344,1267506856,1231795407,35711449,227052846,1004742561,1081768306,1036331080,45437226,232322355,804008725
Ranthambore,Ranthambore,Ranthambore-Ranthambore,BEN_NW12,BEN_NW20,702708039,648061449,237421629,54646590,410639820,147375142,1267506856,1231795407,35711449,227052846,1004742561,1086271749,1022278981,63992768,541693814,480585167
Ranthambore,Ranthambore,Ranthambore-Ranthambore,BEN_NW12,BEN_NW24,706483705,656888599,344424042,49595106,312464557,155124785,1267506856,1231795407,35711449,227052846,1004742561,1159641386,1113494396,46146990,301627698,811866698
Ranthambore,Ranthambore,Ranthambore-Ranthambore,BEN_NW12,BEN_NW3,720387110,674391219,426890352,45995891,247500867,131399288,1267506856,1231795407,35711449,227052846,1004742561,1280728709,1240123254,40605455,207797688,1032325566
Ranthambore,Ranthambore,Ranthambore-Ranthambore,BEN_NW12,BEN_NW4,784320109,747029552,538608276,37290557,208421276,124539269,1267506856,1231795407,35711449,227052846,1004742561,1219365724,1186222475,33143249,158691252,1027531223
Ranthambore,Ranthambore,Ranthambore-Ranthambore,BEN_NW12,BEN_NW5,596091821,544556878,302799719,51534943,241757159,93436973,1267506856,1231795407,35711449,227052846,1004742561,977809134,918585062,59224072,241966240,676618822
Ranthambore,Ranthambore,Ranthambore-Ranthambore,BEN_NW12,BEN_NW55,706297192,654706943,255627942,51590249,399079001,143695682,1267506856,1231795407,35711449,227052846,1004742561,1131174741,1073214798,57959943,534097691,539117107
Ranthambore,Ranthambore,Ranthambore-Ranthambore,BEN_NW12,BEN_NW57,715827266,651872955,218289616,63954311,433583339,123349350,1267506856,1231795407,35711449,227052846,1004742561,1180288036,1103120235,77167801,638361097,464759138
Ranthambore,Ranthambore,Ranthambore-Ranthambore,BEN_NW12,BEN_NW6,616574984,574519937,333899149,42055047,240620788,118502927,1267506856,1231795407,35711449,227052846,1004742561,992143483,946435718,45707765,248527765,697907953
Ranthambore,Ranthambore,Ranthambore-Ranthambore,BEN_NW12,BEN_NW8,819460428,777899796,491712855,41560632,286186941,169245966,1267506856,1231795407,35711449,227052846,1004742561,1196839698,1156984240,39855458,275076038,881908202
Ranthambore,Ranthambore,Ranthambore-Ranthambore,BEN_NW12,BEN_NW9,794027453,750149287,498930156,43878166,251219131,140231257,1267506856,1231795407,35711449,227052846,1004742561,1246521228,1203200533,43320695,216389572,986810961
Ranthambore,Ranthambore,Ranthambore-Ranthambore,BEN_NW13,BEN_NW10,776735444,731149547,371912654,45585897,359236893,188540182,1183131254,1138285233,44846021,344174628,794110605,1266198710,1229664069,36534641,328923565,900740504
Ranthambore,Ranthambore,Ranthambore-Ranthambore,BEN_NW13,BEN_NW11,628261209,583750182,305567410,44511027,278182772,121468806,1183131254,1138285233,44846021,344174628,794110605,997123987,950413379,46710608,263905963,686507416
Ranthambore,Ranthambore,Ranthambore-Ranthambore,BEN_NW13,BEN_NW12,814042835,769960363,434116806,44082472,335843557,183065823,1183131254,1138285233,44846021,344174628,794110605,1267506856,1231795407,35711449,227052846,1004742561
Ranthambore,Ranthambore,Ranthambore-Ranthambore,BEN_NW13,BEN_NW14,829020644,780699845,478489674,48320799,302210171,171051058,1183131254,1138285233,44846021,344174628,794110605,1235716540,1190952996,44763544,177541519,1013411477
Ranthambore,Ranthambore,Ranthambore-Ranthambore,BEN_NW13,BEN_NW17,616134247,576465067,280537364,39669180,295927703,149220488,1183131254,1138285233,44846021,344174628,794110605,1116321554,1085802823,30518731,256140006,829662817
Ranthambore,Ranthambore,Ranthambore-Ranthambore,BEN_NW13,BEN_NW18,768475423,718407569,388251519,50067854,330156050,157136090,1183131254,1138285233,44846021,344174628,794110605,1339364699,1300736006,38628693,242877521,1057858485
Ranthambore,Ranthambore,Ranthambore-Ranthambore,BEN_NW13,BEN_NW19,632878451,585945822,315656625,46932629,270289197,128680985,1183131254,1138285233,44846021,344174628,794110605,1081768306,1036331080,45437226,232322355,804008725
Ranthambore,Ranthambore,Ranthambore-Ranthambore,BEN_NW13,BEN_NW20,649236761,592585587,211050965,56651174,381534622,141535140,1183131254,1138285233,44846021,344174628,794110605,1086271749,1022278981,63992768,541693814,480585167
Ranthambore,Ranthambore,Ranthambore-Ranthambore,BEN_NW13,BEN_NW24,689890351,639934172,297469417,49956179,342464755,165801550,1183131254,1138285233,44846021,344174628,794110605,1159641386,1113494396,46146990,301627698,811866698
Ranthambore,Ranthambore,Ranthambore-Ranthambore,BEN_NW13,BEN_NW3,701231865,651995555,357234149,49236310,294761406,148354847,1183131254,1138285233,44846021,344174628,794110605,1280728709,1240123254,40605455,207797688,1032325566
Ranthambore,Ranthambore,Ranthambore-Ranthambore,BEN_NW13,BEN_NW4,742604561,705041058,440291777,37563503,264749281,172571770,1183131254,1138285233,44846021,344174628,794110605,1219365724,1186222475,33143249,158691252,1027531223
Ranthambore,Ranthambore,Ranthambore-Ranthambore,BEN_NW13,BEN_NW5,624149989,574111854,309249612,50038135,264862242,104931240,1183131254,1138285233,44846021,344174628,794110605,977809134,918585062,59224072,241966240,676618822
Ranthambore,Ranthambore,Ranthambore-Ranthambore,BEN_NW13,BEN_NW55,730701720,673132939,274538089,57568781,398594850,154467816,1183131254,1138285233,44846021,344174628,794110605,1131174741,1073214798,57959943,534097691,539117107
Ranthambore,Ranthambore,Ranthambore-Ranthambore,BEN_NW13,BEN_NW57,698439717,632266755,215673184,66172962,416593571,124014432,1183131254,1138285233,44846021,344174628,794110605,1180288036,1103120235,77167801,638361097,464759138
Ranthambore,Ranthambore,Ranthambore-Ranthambore,BEN_NW13,BEN_NW6,615938511,568647095,287175708,47291416,281471387,128454198,1183131254,1138285233,44846021,344174628,794110605,992143483,946435718,45707765,248527765,697907953
Ranthambore,Ranthambore,Ranthambore-Ranthambore,BEN_NW13,BEN_NW8,731709867,685045805,368736232,46664062,316309573,181942387,1183131254,1138285233,44846021,344174628,794110605,1196839698,1156984240,39855458,275076038,881908202
Ranthambore,Ranthambore,Ranthambore-Ranthambore,BEN_NW13,BEN_NW9,755727190,708122941,401083030,47604249,307039911,172227039,1183131254,1138285233,44846021,344174628,794110605,1246521228,1203200533,43320695,216389572,986810961
Ranthambore,Ranthambore,Ranthambore-Ranthambore,BEN_NW14,BEN_NW10,787398400,743098179,464374873,44300221,278723306,201160304,1235716540,1190952996,44763544,177541519,1013411477,1266198710,1229664069,36534641,328923565,900740504
Ranthambore,Ranthambore,Ranthambore-Ranthambore,BEN_NW14,BEN_NW11,686313559,641443754,420742406,44869805,220701348,124389819,1235716540,1190952996,44763544,177541519,1013411477,997123987,950413379,46710608,263905963,686507416
Ranthambore,Ranthambore,Ranthambore-Ranthambore,BEN_NW14,BEN_NW12,858268756,814342427,579142279,43926329,235200148,148030523,1235716540,1190952996,44763544,177541519,1013411477,1267506856,1231795407,35711449,227052846,1004742561
Ranthambore,Ranthambore,Ranthambore-Ranthambore,BEN_NW14,BEN_NW13,829020644,780699845,478489674,48320799,302210171,171051058,1235716540,1190952996,44763544,177541519,1013411477,1183131254,1138285233,44846021,344174628,794110605
Ranthambore,Ranthambore,Ranthambore-Ranthambore,BEN_NW14,BEN_NW17,683844911,648619399,432620171,35225512,215999228,122759521,1235716540,1190952996,44763544,177541519,1013411477,1116321554,1085802823,30518731,256140006,829662817
Ranthambore,Ranthambore,Ranthambore-Ranthambore,BEN_NW14,BEN_NW18,793201887,744781585,512990822,48420302,231790763,151079482,1235716540,1190952996,44763544,177541519,1013411477,1339364699,1300736006,38628693,242877521,1057858485
Ranthambore,Ranthambore,Ranthambore-Ranthambore,BEN_NW14,BEN_NW19,662632779,615592471,397697194,47040308,217895277,98371032,1235716540,1190952996,44763544,177541519,1013411477,1081768306,1036331080,45437226,232322355,804008725
Ranthambore,Ranthambore,Ranthambore-Ranthambore,BEN_NW14,BEN_NW20,647862155,586564374,217268841,61297781,369295533,131275431,1235716540,1190952996,44763544,177541519,1013411477,1086271749,1022278981,63992768,541693814,480585167
Ranthambore,Ranthambore,Ranthambore-Ranthambore,BEN_NW14,BEN_NW24,666977390,616409681,359659088,50567709,256750593,146685343,1235716540,1190952996,44763544,177541519,1013411477,1159641386,1113494396,46146990,301627698,811866698
Ranthambore,Ranthambore,Ranthambore-Ranthambore,BEN_NW14,BEN_NW3,732131435,682130937,455192188,50000498,226938749,117147912,1235716540,1190952996,44763544,177541519,1013411477,1280728709,1240123254,40605455,207797688,1032325566
Ranthambore,Ranthambore,Ranthambore-Ranthambore,BEN_NW14,BEN_NW4,766733365,727374165,553696606,39359200,173677559,102574945,1235716540,1190952996,44763544,177541519,1013411477,1219365724,1186222475,33143249,158691252,1027531223
Ranthambore,Ranthambore,Ranthambore-Ranthambore,BEN_NW14,BEN_NW5,570115591,517546711,319440160,52568880,198106551,66358537,1235716540,1190952996,44763544,177541519,1013411477,977809134,918585062,59224072,241966240,676618822
Ranthambore,Ranthambore,Ranthambore-Ranthambore,BEN_NW14,BEN_NW55,722334935,667035224,298311888,55299711,368723336,160875007,1235716540,1190952996,44763544,177541519,1013411477,1131174741,1073214798,57959943,534097691,539117107
Ranthambore,Ranthambore,Ranthambore-Ranthambore,BEN_NW14,BEN_NW57,722969706,654846235,236448000,68123471,418398235,129951086,1235716540,1190952996,44763544,177541519,1013411477,1180288036,1103120235,77167801,638361097,464759138
Ranthambore,Ranthambore,Ranthambore-Ranthambore,BEN_NW14,BEN_NW6,657298043,612623273,401135738,44674770,211487535,115600802,1235716540,1190952996,44763544,177541519,1013411477,992143483,946435718,45707765,248527765,697907953
Ranthambore,Ranthambore,Ranthambore-Ranthambore,BEN_NW14,BEN_NW8,726134344,678613158,438729970,47521186,239883188,154492051,1235716540,1190952996,44763544,177541519,1013411477,1196839698,1156984240,39855458,275076038,881908202
Ranthambore,Ranthambore,Ranthambore-Ranthambore,BEN_NW14,BEN_NW9,799384348,750593897,544473971,48790451,206119926,157046725,1235716540,1190952996,44763544,177541519,1013411477,1246521228,1203200533,43320695,216389572,986810961
Ranthambore,Ranthambore,Ranthambore-Ranthambore,BEN_NW17,BEN_NW10,679182990,642041942,369031954,37141048,273009988,180321309,1116321554,1085802823,30518731,256140006,829662817,1266198710,1229664069,36534641,328923565,900740504
Ranthambore,Ranthambore,Ranthambore-Ranthambore,BEN_NW17,BEN_NW11,595078516,560721805,320287601,34356711,240434204,139190757,1116321554,1085802823,30518731,256140006,829662817,997123987,950413379,46710608,263905963,686507416
Ranthambore,Ranthambore,Ranthambore-Ranthambore,BEN_NW17,BEN_NW12,686036191,650847755,394512514,35188436,256335241,143313876,1116321554,1085802823,30518731,256140006,829662817,1267506856,1231795407,35711449,227052846,1004742561
Ranthambore,Ranthambore,Ranthambore-Ranthambore,BEN_NW17,BEN_NW13,616134247,576465067,280537364,39669180,295927703,149220488,1116321554,1085802823,30518731,256140006,829662817,1183131254,1138285233,44846021,344174628,794110605
Ranthambore,Ranthambore,Ranthambore-Ranthambore,BEN_NW17,BEN_NW14,683844911,648619399,432620171,35225512,215999228,122759521,1116321554,1085802823,30518731,256140006,829662817,1235716540,1190952996,44763544,177541519,1013411477
Ranthambore,Ranthambore,Ranthambore-Ranthambore,BEN_NW17,BEN_NW18,745290051,710921459,457256279,34368592,253665180,146301775,1116321554,1085802823,30518731,256140006,829662817,1339364699,1300736006,38628693,242877521,1057858485
Ranthambore,Ranthambore,Ranthambore-Ranthambore,BEN_NW17,BEN_NW19,655144877,618575858,373092210,36569019,245483648,113428709,1116321554,1085802823,30518731,256140006,829662817,1081768306,1036331080,45437226,232322355,804008725
Ranthambore,Ranthambore,Ranthambore-Ranthambore,BEN_NW17,BEN_NW20,587278384,536097179,185880895,51181205,350216284,125702236,1116321554,1085802823,30518731,256140006,829662817,1086271749,1022278981,63992768,541693814,480585167
Ranthambore,Ranthambore,Ranthambore-Ranthambore,BEN_NW17,BEN_NW24,642446200,604018019,322003972,38428181,282014047,162930883,1116321554,1085802823,30518731,256140006,829662817,1159641386,1113494396,46146990,301627698,811866698
Ranthambore,Ranthambore,Ranthambore-Ranthambore,BEN_NW17,BEN_NW3,691563653,652550869,397290124,39012784,255260745,122157307,1116321554,1085802823,30518731,256140006,829662817,1280728709,1240123254,40605455,207797688,1032325566
Ranthambore,Ranthambore,Ranthambore-Ranthambore,BEN_NW17,BEN_NW4,652300745,617702639,386974776,34598106,230727863,125361284,1116321554,1085802823,30518731,256140006,829662817,1219365724,1186222475,33143249,158691252,1027531223
Ranthambore,Ranthambore,Ranthambore-Ranthambore,BEN_NW17,BEN_NW5,525847218,485327891,254216773,40519327,231111118,99656147,1116321554,1085802823,30518731,256140006,829662817,977809134,918585062,59224072,241966240,676618822
Ranthambore,Ranthambore,Ranthambore-Ranthambore,BEN_NW17,BEN_NW55,616639204,571870792,205926655,44768412,365944137,133269005,1116321554,1085802823,30518731,256140006,829662817,1131174741,1073214798,57959943,534097691,539117107
Ranthambore,Ranthambore,Ranthambore-Ranthambore,BEN_NW17,BEN_NW57,645912366,587368094,175723375,58544272,411644719,116671146,1116321554,1085802823,30518731,256140006,829662817,1180288036,1103120235,77167801,638361097,464759138
Ranthambore,Ranthambore,Ranthambore-Ranthambore,BEN_NW17,BEN_NW6,584708941,550125614,314261127,34583327,235864487,127900282,1116321554,1085802823,30518731,256140006,829662817,992143483,946435718,45707765,248527765,697907953
Ranthambore,Ranthambore,Ranthambore-Ranthambore,BEN_NW17,BEN_NW8,670864644,634107492,368864170,36757152,265243322,172321104,1116321554,1085802823,30518731,256140006,829662817,1196839698,1156984240,39855458,275076038,881908202
Ranthambore,Ranthambore,Ranthambore-Ranthambore,BEN_NW17,BEN_NW9,712303342,673829083,417844536,38474259,255984547,151179728,1116321554,1085802823,30518731,256140006,829662817,1246521228,1203200533,43320695,216389572,986810961
Ranthambore,Ranthambore,Ranthambore-Ranthambore,BEN_NW18,BEN_NW10,869572738,829808913,526376170,39763825,303432743,217898065,1339364699,1300736006,38628693,242877521,1057858485,1266198710,1229664069,36534641,328923565,900740504
Ranthambore,Ranthambore,Ranthambore-Ranthambore,BEN_NW18,BEN_NW11,680386622,634689855,366417254,45696767,268272601,150181442,1339364699,1300736006,38628693,242877521,1057858485,997123987,950413379,46710608,263905963,686507416
Ranthambore,Ranthambore,Ranthambore-Ranthambore,BEN_NW18,BEN_NW12,827546478,785009837,512442277,42536641,272567560,157589214,1339364699,1300736006,38628693,242877521,1057858485,1267506856,1231795407,35711449,227052846,1004742561
Ranthambore,Ranthambore,Ranthambore-Ranthambore,BEN_NW18,BEN_NW13,768475423,718407569,388251519,50067854,330156050,157136090,1339364699,1300736006,38628693,242877521,1057858485,1183131254,1138285233,44846021,344174628,794110605
Ranthambore,Ranthambore,Ranthambore-Ranthambore,BEN_NW18,BEN_NW14,793201887,744781585,512990822,48420302,231790763,151079482,1339364699,1300736006,38628693,242877521,1057858485,1235716540,1190952996,44763544,177541519,1013411477
Ranthambore,Ranthambore,Ranthambore-Ranthambore,BEN_NW18,BEN_NW17,745290051,710921459,457256279,34368592,253665180,146301775,1339364699,1300736006,38628693,242877521,1057858485,1116321554,1085802823,30518731,256140006,829662817
Ranthambore,Ranthambore,Ranthambore-Ranthambore,BEN_NW18,BEN_NW19,701973479,655589497,402478426,46383982,253111071,126687372,1339364699,1300736006,38628693,242877521,1057858485,1081768306,1036331080,45437226,232322355,804008725
Ranthambore,Ranthambore,Ranthambore-Ranthambore,BEN_NW18,BEN_NW20,722977440,662553399,240101466,60424041,422451933,155576054,1339364699,1300736006,38628693,242877521,1057858485,1086271749,1022278981,63992768,541693814,480585167
Ranthambore,Ranthambore,Ranthambore-Ranthambore,BEN_NW18,BEN_NW24,744886282,695505619,379530612,49380663,315975007,181325235,1339364699,1300736006,38628693,242877521,1057858485,1159641386,1113494396,46146990,301627698,811866698
Ranthambore,Ranthambore,Ranthambore-Ranthambore,BEN_NW18,BEN_NW3,823266132,778980359,515576578,44285773,263403781,150825737,1339364699,1300736006,38628693,242877521,1057858485,1280728709,1240123254,40605455,207797688,1032325566
Ranthambore,Ranthambore,Ranthambore-Ranthambore,BEN_NW18,BEN_NW4,821086629,783158236,558411700,37928393,224746536,146492332,1339364699,1300736006,38628693,242877521,1057858485,1219365724,1186222475,33143249,158691252,1027531223
Ranthambore,Ranthambore,Ranthambore-Ranthambore,BEN_NW18,BEN_NW5,639777240,587329280,342333966,52447960,244995314,116336301,1339364699,1300736006,38628693,242877521,1057858485,977809134,918585062,59224072,241966240,676618822
Ranthambore,Ranthambore,Ranthambore-Ranthambore,BEN_NW18,BEN_NW55,785322935,726723439,300268909,58599496,426454530,164033840,1339364699,1300736006,38628693,242877521,1057858485,1131174741,1073214798,57959943,534097691,539117107
Ranthambore,Ranthambore,Ranthambore-Ranthambore,BEN_NW18,BEN_NW57,792446832,720420933,245447564,72025899,474973369,156508887,1339364699,1300736006,38628693,242877521,1057858485,1180288036,1103120235,77167801,638361097,464759138
Ranthambore,Ranthambore,Ranthambore-Ranthambore,BEN_NW18,BEN_NW6,732586450,691630366,436651805,40956084,254978561,129418900,1339364699,1300736006,38628693,242877521,1057858485,992143483,946435718,45707765,248527765,697907953
Ranthambore,Ranthambore,Ranthambore-Ranthambore,BEN_NW18,BEN_NW8,807850666,763529060,472163835,44321606,291365225,181407193,1339364699,1300736006,38628693,242877521,1057858485,1196839698,1156984240,39855458,275076038,881908202
Ranthambore,Ranthambore,Ranthambore-Ranthambore,BEN_NW18,BEN_NW9,750518226,699044573,427321021,51473653,271723552,149819232,1339364699,1300736006,38628693,242877521,1057858485,1246521228,1203200533,43320695,216389572,986810961
Ranthambore,Ranthambore,Ranthambore-Ranthambore,BEN_NW19,BEN_NW10,702571424,657269716,371664651,45301708,285605065,171213056,1081768306,1036331080,45437226,232322355,804008725,1266198710,1229664069,36534641,328923565,900740504
Ranthambore,Ranthambore,Ranthambore-Ranthambore,BEN_NW19,BEN_NW11,584968410,541574790,308947363,43393620,232627427,122155235,1081768306,1036331080,45437226,232322355,804008725,997123987,950413379,46710608,263905963,686507416
Ranthambore,Ranthambore,Ranthambore-Ranthambore,BEN_NW19,BEN_NW12,694727591,649639220,403604670,45088371,246034550,131870344,1081768306,1036331080,45437226,232322355,804008725,1267506856,1231795407,35711449,227052846,1004742561
Ranthambore,Ranthambore,Ranthambore-Ranthambore,BEN_NW19,BEN_NW13,632878451,585945822,315656625,46932629,270289197,128680985,1081768306,1036331080,45437226,232322355,804008725,1183131254,1138285233,44846021,344174628,794110605
Ranthambore,Ranthambore,Ranthambore-Ranthambore,BEN_NW19,BEN_NW14,662632779,615592471,397697194,47040308,217895277,98371032,1081768306,1036331080,45437226,232322355,804008725,1235716540,1190952996,44763544,177541519,1013411477
Ranthambore,Ranthambore,Ranthambore-Ranthambore,BEN_NW19,BEN_NW17,655144877,618575858,373092210,36569019,245483648,113428709,1081768306,1036331080,45437226,232322355,804008725,1116321554,1085802823,30518731,256140006,829662817
Ranthambore,Ranthambore,Ranthambore-Ranthambore,BEN_NW19,BEN_NW18,701973479,655589497,402478426,46383982,253111071,126687372,1081768306,1036331080,45437226,232322355,804008725,1339364699,1300736006,38628693,242877521,1057858485
Ranthambore,Ranthambore,Ranthambore-Ranthambore,BEN_NW19,BEN_NW20,604430283,544289615,201477092,60140668,342812523,117553710,1081768306,1036331080,45437226,232322355,804008725,1086271749,1022278981,63992768,541693814,480585167
Ranthambore,Ranthambore,Ranthambore-Ranthambore,BEN_NW19,BEN_NW24,627644980,577996568,311424218,49648412,266572350,120855596,1081768306,1036331080,45437226,232322355,804008725,1159641386,1113494396,46146990,301627698,811866698
Ranthambore,Ranthambore,Ranthambore-Ranthambore,BEN_NW19,BEN_NW3,758349492,712179799,488576445,46169693,223603354,97653370,1081768306,1036331080,45437226,232322355,804008725,1280728709,1240123254,40605455,207797688,1032325566
Ranthambore,Ranthambore,Ranthambore-Ranthambore,BEN_NW19,BEN_NW4,625364412,584953058,379072305,40411354,205880753,72415925,1081768306,1036331080,45437226,232322355,804008725,1219365724,1186222475,33143249,158691252,1027531223
Ranthambore,Ranthambore,Ranthambore-Ranthambore,BEN_NW19,BEN_NW5,556710176,506829798,287990957,49880378,218838841,83555581,1081768306,1036331080,45437226,232322355,804008725,977809134,918585062,59224072,241966240,676618822
Ranthambore,Ranthambore,Ranthambore-Ranthambore,BEN_NW19,BEN_NW55,620987513,568064371,237256430,52923142,330807941,132005954,1081768306,1036331080,45437226,232322355,804008725,1131174741,1073214798,57959943,534097691,539117107
Ranthambore,Ranthambore,Ranthambore-Ranthambore,BEN_NW19,BEN_NW57,632151303,565486191,186751113,66665112,378735078,121018078,1081768306,1036331080,45437226,232322355,804008725,1180288036,1103120235,77167801,638361097,464759138
Ranthambore,Ranthambore,Ranthambore-Ranthambore,BEN_NW19,BEN_NW6,600816511,559036735,351932541,41779776,207104194,117614837,1081768306,1036331080,45437226,232322355,804008725,992143483,946435718,45707765,248527765,697907953
Ranthambore,Ranthambore,Ranthambore-Ranthambore,BEN_NW19,BEN_NW8,660557592,614539981,372571969,46017611,241968012,140945660,1081768306,1036331080,45437226,232322355,804008725,1196839698,1156984240,39855458,275076038,881908202
Ranthambore,Ranthambore,Ranthambore-Ranthambore,BEN_NW19,BEN_NW9,665045026,616045761,378518485,48999265,237527276,103775551,1081768306,1036331080,45437226,232322355,804008725,1246521228,1203200533,43320695,216389572,986810961
Ranthambore,Ranthambore,Ranthambore-Ranthambore,BEN_NW20,BEN_NW10,704639241,645680212,232848389,58959029,412831823,157642554,1086271749,1022278981,63992768,541693814,480585167,1266198710,1229664069,36534641,328923565,900740504
Ranthambore,Ranthambore,Ranthambore-Ranthambore,BEN_NW20,BEN_NW11,572787769,515996307,197152874,56791462,318843433,112752171,1086271749,1022278981,63992768,541693814,480585167,997123987,950413379,46710608,263905963,686507416
Ranthambore,Ranthambore,Ranthambore-Ranthambore,BEN_NW20,BEN_NW12,702708039,648061449,237421629,54646590,410639820,147375142,1086271749,1022278981,63992768,541693814,480585167,1267506856,1231795407,35711449,227052846,1004742561
Ranthambore,Ranthambore,Ranthambore-Ranthambore,BEN_NW20,BEN_NW13,649236761,592585587,211050965,56651174,381534622,141535140,1086271749,1022278981,63992768,541693814,480585167,1183131254,1138285233,44846021,344174628,794110605
Ranthambore,Ranthambore,Ranthambore-Ranthambore,BEN_NW20,BEN_NW14,647862155,586564374,217268841,61297781,369295533,131275431,1086271749,1022278981,63992768,541693814,480585167,1235716540,1190952996,44763544,177541519,1013411477
Ranthambore,Ranthambore,Ranthambore-Ranthambore,BEN_NW20,BEN_NW17,587278384,536097179,185880895,51181205,350216284,125702236,1086271749,1022278981,63992768,541693814,480585167,1116321554,1085802823,30518731,256140006,829662817
Ranthambore,Ranthambore,Ranthambore-Ranthambore,BEN_NW20,BEN_NW18,722977440,662553399,240101466,60424041,422451933,155576054,1086271749,1022278981,63992768,541693814,480585167,1339364699,1300736006,38628693,242877521,1057858485
Ranthambore,Ranthambore,Ranthambore-Ranthambore,BEN_NW20,BEN_NW19,604430283,544289615,201477092,60140668,342812523,117553710,1086271749,1022278981,63992768,541693814,480585167,1081768306,1036331080,45437226,232322355,804008725
Ranthambore,Ranthambore,Ranthambore-Ranthambore,BEN_NW20,BEN_NW24,613125820,549395819,177328049,63730001,372067770,115037726,1086271749,1022278981,63992768,541693814,480585167,1159641386,1113494396,46146990,301627698,811866698
Ranthambore,Ranthambore,Ranthambore-Ranthambore,BEN_NW20,BEN_NW3,610119106,549513517,193939335,60605589,355574182,119448052,1086271749,1022278981,63992768,541693814,480585167,1280728709,1240123254,40605455,207797688,1032325566
Ranthambore,Ranthambore,Ranthambore-Ranthambore,BEN_NW20,BEN_NW4,672202918,621316154,261236401,50886764,360079753,134082835,1086271749,1022278981,63992768,541693814,480585167,1219365724,1186222475,33143249,158691252,1027531223
Ranthambore,Ranthambore,Ranthambore-Ranthambore,BEN_NW20,BEN_NW5,535930929,474365324,168570328,61565605,305794996,88456310,1086271749,1022278981,63992768,541693814,480585167,977809134,918585062,59224072,241966240,676618822
Ranthambore,Ranthambore,Ranthambore-Ranthambore,BEN_NW20,BEN_NW55,633494136,574201856,187035362,59292280,387166494,117918381,1086271749,1022278981,63992768,541693814,480585167,1131174741,1073214798,57959943,534097691,539117107
Ranthambore,Ranthambore,Ranthambore-Ranthambore,BEN_NW20,BEN_NW57,668708667,604990482,204745137,63718185,400245345,128204132,1086271749,1022278981,63992768,541693814,480585167,1180288036,1103120235,77167801,638361097,464759138
Ranthambore,Ranthambore,Ranthambore-Ranthambore,BEN_NW20,BEN_NW6,601515069,547846386,206986438,53668683,340859948,126246504,1086271749,1022278981,63992768,541693814,480585167,992143483,946435718,45707765,248527765,697907953
Ranthambore,Ranthambore,Ranthambore-Ranthambore,BEN_NW20,BEN_NW8,645861910,585551535,192395601,60310375,393155934,114753186,1086271749,1022278981,63992768,541693814,480585167,1196839698,1156984240,39855458,275076038,881908202
Ranthambore,Ranthambore,Ranthambore-Ranthambore,BEN_NW20,BEN_NW9,683582446,624314970,248093688,59267476,376221282,151097777,1086271749,1022278981,63992768,541693814,480585167,1246521228,1203200533,43320695,216389572,986810961
Ranthambore,Ranthambore,Ranthambore-Ranthambore,BEN_NW24,BEN_NW10,652408911,603414805,280066663,48994106,323348142,161413429,1159641386,1113494396,46146990,301627698,811866698,1266198710,1229664069,36534641,328923565,900740504
Ranthambore,Ranthambore,Ranthambore-Ranthambore,BEN_NW24,BEN_NW11,562642257,514058880,248471615,48583377,265587265,125036883,1159641386,1113494396,46146990,301627698,811866698,997123987,950413379,46710608,263905963,686507416
Ranthambore,Ranthambore,Ranthambore-Ranthambore,BEN_NW24,BEN_NW12,706483705,656888599,344424042,49595106,312464557,155124785,1159641386,1113494396,46146990,301627698,811866698,1267506856,1231795407,35711449,227052846,1004742561
Ranthambore,Ranthambore,Ranthambore-Ranthambore,BEN_NW24,BEN_NW13,689890351,639934172,297469417,49956179,342464755,165801550,1159641386,1113494396,46146990,301627698,811866698,1183131254,1138285233,44846021,344174628,794110605
Ranthambore,Ranthambore,Ranthambore-Ranthambore,BEN_NW24,BEN_NW14,666977390,616409681,359659088,50567709,256750593,146685343,1159641386,1113494396,46146990,301627698,811866698,1235716540,1190952996,44763544,177541519,1013411477
Ranthambore,Ranthambore,Ranthambore-Ranthambore,BEN_NW24,BEN_NW17,642446200,604018019,322003972,38428181,282014047,162930883,1159641386,1113494396,46146990,301627698,811866698,1116321554,1085802823,30518731,256140006,829662817
Ranthambore,Ranthambore,Ranthambore-Ranthambore,BEN_NW24,BEN_NW18,744886282,695505619,379530612,49380663,315975007,181325235,1159641386,1113494396,46146990,301627698,811866698,1339364699,1300736006,38628693,242877521,1057858485
Ranthambore,Ranthambore,Ranthambore-Ranthambore,BEN_NW24,BEN_NW19,627644980,577996568,311424218,49648412,266572350,120855596,1159641386,1113494396,46146990,301627698,811866698,1081768306,1036331080,45437226,232322355,804008725
Ranthambore,Ranthambore,Ranthambore-Ranthambore,BEN_NW24,BEN_NW20,613125820,549395819,177328049,63730001,372067770,115037726,1159641386,1113494396,46146990,301627698,811866698,1086271749,1022278981,63992768,541693814,480585167
Ranthambore,Ranthambore,Ranthambore-Ranthambore,BEN_NW24,BEN_NW3,686988825,635188267,350058562,51800558,285129705,137445524,1159641386,1113494396,46146990,301627698,811866698,1280728709,1240123254,40605455,207797688,1032325566
Ranthambore,Ranthambore,Ranthambore-Ranthambore,BEN_NW24,BEN_NW4,674781901,629693712,366372303,45088189,263321409,156429641,1159641386,1113494396,46146990,301627698,811866698,1219365724,1186222475,33143249,158691252,1027531223
Ranthambore,Ranthambore,Ranthambore-Ranthambore,BEN_NW24,BEN_NW5,619669824,566024334,310921596,53645490,255102738,111793300,1159641386,1113494396,46146990,301627698,811866698,977809134,918585062,59224072,241966240,676618822
Ranthambore,Ranthambore,Ranthambore-Ranthambore,BEN_NW24,BEN_NW55,629096628,569988495,213121479,59108133,356867016,134109572,1159641386,1113494396,46146990,301627698,811866698,1131174741,1073214798,57959943,534097691,539117107
Ranthambore,Ranthambore,Ranthambore-Ranthambore,BEN_NW24,BEN_NW57,651947190,579126645,176850235,72820545,402276410,118149265,1159641386,1113494396,46146990,301627698,811866698,1180288036,1103120235,77167801,638361097,464759138
Ranthambore,Ranthambore,Ranthambore-Ranthambore,BEN_NW24,BEN_NW6,561084151,511820820,241821627,49263331,269999193,112293403,1159641386,1113494396,46146990,301627698,811866698,992143483,946435718,45707765,248527765,697907953
Ranthambore,Ranthambore,Ranthambore-Ranthambore,BEN_NW24,BEN_NW8,649051667,596829005,298245582,52222662,298583423,169247491,1159641386,1113494396,46146990,301627698,811866698,1196839698,1156984240,39855458,275076038,881908202
Ranthambore,Ranthambore,Ranthambore-Ranthambore,BEN_NW24,BEN_NW9,695752688,644314621,370659717,51438067,273654904,165467849,1159641386,1113494396,46146990,301627698,811866698,1246521228,1203200533,43320695,216389572,986810961
Ranthambore,Ranthambore,Ranthambore-Ranthambore,BEN_NW3,BEN_NW10,760754865,717205215,419229109,43549650,297976106,192598568,1280728709,1240123254,40605455,207797688,1032325566,1266198710,1229664069,36534641,328923565,900740504
Ranthambore,Ranthambore,Ranthambore-Ranthambore,BEN_NW3,BEN_NW11,601381431,556984350,313814837,44397081,243169513,123614321,1280728709,1240123254,40605455,207797688,1032325566,997123987,950413379,46710608,263905963,686507416
Ranthambore,Ranthambore,Ranthambore-Ranthambore,BEN_NW3,BEN_NW12,720387110,674391219,426890352,45995891,247500867,131399288,1280728709,1240123254,40605455,207797688,1032325566,1267506856,1231795407,35711449,227052846,1004742561
Ranthambore,Ranthambore,Ranthambore-Ranthambore,BEN_NW3,BEN_NW13,701231865,651995555,357234149,49236310,294761406,148354847,1280728709,1240123254,40605455,207797688,1032325566,1183131254,1138285233,44846021,344174628,794110605
Ranthambore,Ranthambore,Ranthambore-Ranthambore,BEN_NW3,BEN_NW14,732131435,682130937,455192188,50000498,226938749,117147912,1280728709,1240123254,40605455,207797688,1032325566,1235716540,1190952996,44763544,177541519,1013411477
Ranthambore,Ranthambore,Ranthambore-Ranthambore,BEN_NW3,BEN_NW17,691563653,652550869,397290124,39012784,255260745,122157307,1280728709,1240123254,40605455,207797688,1032325566,1116321554,1085802823,30518731,256140006,829662817
Ranthambore,Ranthambore,Ranthambore-Ranthambore,BEN_NW3,BEN_NW18,823266132,778980359,515576578,44285773,263403781,150825737,1280728709,1240123254,40605455,207797688,1032325566,1339364699,1300736006,38628693,242877521,1057858485
Ranthambore,Ranthambore,Ranthambore-Ranthambore,BEN_NW3,BEN_NW19,758349492,712179799,488576445,46169693,223603354,97653370,1280728709,1240123254,40605455,207797688,1032325566,1081768306,1036331080,45437226,232322355,804008725
Ranthambore,Ranthambore,Ranthambore-Ranthambore,BEN_NW3,BEN_NW20,610119106,549513517,193939335,60605589,355574182,119448052,1280728709,1240123254,40605455,207797688,1032325566,1086271749,1022278981,63992768,541693814,480585167
Ranthambore,Ranthambore,Ranthambore-Ranthambore,BEN_NW3,BEN_NW24,686988825,635188267,350058562,51800558,285129705,137445524,1280728709,1240123254,40605455,207797688,1032325566,1159641386,1113494396,46146990,301627698,811866698
Ranthambore,Ranthambore,Ranthambore-Ranthambore,BEN_NW3,BEN_NW4,765303416,728466251,525767965,36837165,202698286,107031805,1280728709,1240123254,40605455,207797688,1032325566,1219365724,1186222475,33143249,158691252,1027531223
Ranthambore,Ranthambore,Ranthambore-Ranthambore,BEN_NW3,BEN_NW5,602408072,551161302,315391557,51246770,235769745,84093210,1280728709,1240123254,40605455,207797688,1032325566,977809134,918585062,59224072,241966240,676618822
Ranthambore,Ranthambore,Ranthambore-Ranthambore,BEN_NW3,BEN_NW55,702780062,645862103,269280768,56917959,376581335,155726406,1280728709,1240123254,40605455,207797688,1032325566,1131174741,1073214798,57959943,534097691,539117107
Ranthambore,Ranthambore,Ranthambore-Ranthambore,BEN_NW3,BEN_NW57,727350380,654550269,209818599,72800111,444731670,119540050,1280728709,1240123254,40605455,207797688,1032325566,1180288036,1103120235,77167801,638361097,464759138
Ranthambore,Ranthambore,Ranthambore-Ranthambore,BEN_NW3,BEN_NW6,634509733,589759838,367812536,44749895,221947302,119705506,1280728709,1240123254,40605455,207797688,1032325566,992143483,946435718,45707765,248527765,697907953
Ranthambore,Ranthambore,Ranthambore-Ranthambore,BEN_NW3,BEN_NW8,681135338,633138326,371242724,47997012,261895602,151691317,1280728709,1240123254,40605455,207797688,1032325566,1196839698,1156984240,39855458,275076038,881908202
Ranthambore,Ranthambore,Ranthambore-Ranthambore,BEN_NW3,BEN_NW9,721470794,671803496,419724608,49667298,252078888,109693426,1280728709,1240123254,40605455,207797688,1032325566,1246521228,1203200533,43320695,216389572,986810961
Ranthambore,Ranthambore,Ranthambore-Ranthambore,BEN_NW4,BEN_NW10,764437292,727626566,452792346,36810726,274834220,190479179,1219365724,1186222475,33143249,158691252,1027531223,1266198710,1229664069,36534641,328923565,900740504
Ranthambore,Ranthambore,Ranthambore-Ranthambore,BEN_NW4,BEN_NW11,605851185,568308552,355861560,37542633,212446992,125611510,1219365724,1186222475,33143249,158691252,1027531223,997123987,950413379,46710608,263905963,686507416
Ranthambore,Ranthambore,Ranthambore-Ranthambore,BEN_NW4,BEN_NW12,784320109,747029552,538608276,37290557,208421276,124539269,1219365724,1186222475,33143249,158691252,1027531223,1267506856,1231795407,35711449,227052846,1004742561
Ranthambore,Ranthambore,Ranthambore-Ranthambore,BEN_NW4,BEN_NW13,742604561,705041058,440291777,37563503,264749281,172571770,1219365724,1186222475,33143249,158691252,1027531223,1183131254,1138285233,44846021,344174628,794110605
Ranthambore,Ranthambore,Ranthambore-Ranthambore,BEN_NW4,BEN_NW14,766733365,727374165,553696606,39359200,173677559,102574945,1219365724,1186222475,33143249,158691252,1027531223,1235716540,1190952996,44763544,177541519,1013411477
Ranthambore,Ranthambore,Ranthambore-Ranthambore,BEN_NW4,BEN_NW17,652300745,617702639,386974776,34598106,230727863,125361284,1219365724,1186222475,33143249,158691252,1027531223,1116321554,1085802823,30518731,256140006,829662817
Ranthambore,Ranthambore,Ranthambore-Ranthambore,BEN_NW4,BEN_NW18,821086629,783158236,558411700,37928393,224746536,146492332,1219365724,1186222475,33143249,158691252,1027531223,1339364699,1300736006,38628693,242877521,1057858485
Ranthambore,Ranthambore,Ranthambore-Ranthambore,BEN_NW4,BEN_NW19,625364412,584953058,379072305,40411354,205880753,72415925,1219365724,1186222475,33143249,158691252,1027531223,1081768306,1036331080,45437226,232322355,804008725
Ranthambore,Ranthambore,Ranthambore-Ranthambore,BEN_NW4,BEN_NW20,672202918,621316154,261236401,50886764,360079753,134082835,1219365724,1186222475,33143249,158691252,1027531223,1086271749,1022278981,63992768,541693814,480585167
Ranthambore,Ranthambore,Ranthambore-Ranthambore,BEN_NW4,BEN_NW24,674781901,629693712,366372303,45088189,263321409,156429641,1219365724,1186222475,33143249,158691252,1027531223,1159641386,1113494396,46146990,301627698,811866698
Ranthambore,Ranthambore,Ranthambore-Ranthambore,BEN_NW4,BEN_NW3,765303416,728466251,525767965,36837165,202698286,107031805,1219365724,1186222475,33143249,158691252,1027531223,1280728709,1240123254,40605455,207797688,1032325566
Ranthambore,Ranthambore,Ranthambore-Ranthambore,BEN_NW4,BEN_NW5,622537870,576228784,371181010,46309086,205047774,90961879,1219365724,1186222475,33143249,158691252,1027531223,977809134,918585062,59224072,241966240,676618822
Ranthambore,Ranthambore,Ranthambore-Ranthambore,BEN_NW4,BEN_NW55,704307169,657716273,315744722,46590896,341971551,159097126,1219365724,1186222475,33143249,158691252,1027531223,1131174741,1073214798,57959943,534097691,539117107
Ranthambore,Ranthambore,Ranthambore-Ranthambore,BEN_NW4,BEN_NW57,677613331,617094409,224300437,60518922,392793972,124650674,1219365724,1186222475,33143249,158691252,1027531223,1180288036,1103120235,77167801,638361097,464759138
Ranthambore,Ranthambore,Ranthambore-Ranthambore,BEN_NW4,BEN_NW6,599187739,561325651,361160829,37862088,200164822,93809818,1219365724,1186222475,33143249,158691252,1027531223,992143483,946435718,45707765,248527765,697907953
Ranthambore,Ranthambore,Ranthambore-Ranthambore,BEN_NW4,BEN_NW8,772408360,732903954,488970871,39504406,243933083,182300188,1219365724,1186222475,33143249,158691252,1027531223,1196839698,1156984240,39855458,275076038,881908202
Ranthambore,Ranthambore,Ranthambore-Ranthambore,BEN_NW4,BEN_NW9,861455400,821468808,612362146,39986592,209106662,126446201,1219365724,1186222475,33143249,158691252,1027531223,1246521228,1203200533,43320695,216389572,986810961
Ranthambore,Ranthambore,Ranthambore-Ranthambore,BEN_NW5,BEN_NW10,608066748,556378431,292790042,51688317,263588389,125466686,977809134,918585062,59224072,241966240,676618822,1266198710,1229664069,36534641,328923565,900740504
Ranthambore,Ranthambore,Ranthambore-Ranthambore,BEN_NW5,BEN_NW11,565218417,519898038,306640941,45320379,213257097,95515600,977809134,918585062,59224072,241966240,676618822,997123987,950413379,46710608,263905963,686507416
Ranthambore,Ranthambore,Ranthambore-Ranthambore,BEN_NW5,BEN_NW12,596091821,544556878,302799719,51534943,241757159,93436973,977809134,918585062,59224072,241966240,676618822,1267506856,1231795407,35711449,227052846,1004742561
Ranthambore,Ranthambore,Ranthambore-Ranthambore,BEN_NW5,BEN_NW13,624149989,574111854,309249612,50038135,264862242,104931240,977809134,918585062,59224072,241966240,676618822,1183131254,1138285233,44846021,344174628,794110605
Ranthambore,Ranthambore,Ranthambore-Ranthambore,BEN_NW5,BEN_NW14,570115591,517546711,319440160,52568880,198106551,66358537,977809134,918585062,59224072,241966240,676618822,1235716540,1190952996,44763544,177541519,1013411477
Ranthambore,Ranthambore,Ranthambore-Ranthambore,BEN_NW5,BEN_NW17,525847218,485327891,254216773,40519327,231111118,99656147,977809134,918585062,59224072,241966240,676618822,1116321554,1085802823,30518731,256140006,829662817
Ranthambore,Ranthambore,Ranthambore-Ranthambore,BEN_NW5,BEN_NW18,639777240,587329280,342333966,52447960,244995314,116336301,977809134,918585062,59224072,241966240,676618822,1339364699,1300736006,38628693,242877521,1057858485
Ranthambore,Ranthambore,Ranthambore-Ranthambore,BEN_NW5,BEN_NW19,556710176,506829798,287990957,49880378,218838841,83555581,977809134,918585062,59224072,241966240,676618822,1081768306,1036331080,45437226,232322355,804008725
Ranthambore,Ranthambore,Ranthambore-Ranthambore,BEN_NW5,BEN_NW20,535930929,474365324,168570328,61565605,305794996,88456310,977809134,918585062,59224072,241966240,676618822,1086271749,1022278981,63992768,541693814,480585167
Ranthambore,Ranthambore,Ranthambore-Ranthambore,BEN_NW5,BEN_NW24,619669824,566024334,310921596,53645490,255102738,111793300,977809134,918585062,59224072,241966240,676618822,1159641386,1113494396,46146990,301627698,811866698
Ranthambore,Ranthambore,Ranthambore-Ranthambore,BEN_NW5,BEN_NW3,602408072,551161302,315391557,51246770,235769745,84093210,977809134,918585062,59224072,241966240,676618822,1280728709,1240123254,40605455,207797688,1032325566
Ranthambore,Ranthambore,Ranthambore-Ranthambore,BEN_NW5,BEN_NW4,622537870,576228784,371181010,46309086,205047774,90961879,977809134,918585062,59224072,241966240,676618822,1219365724,1186222475,33143249,158691252,1027531223
Ranthambore,Ranthambore,Ranthambore-Ranthambore,BEN_NW5,BEN_NW55,607698052,550699358,229640343,56998694,321059015,113604185,977809134,918585062,59224072,241966240,676618822,1131174741,1073214798,57959943,534097691,539117107
Ranthambore,Ranthambore,Ranthambore-Ranthambore,BEN_NW5,BEN_NW57,585164551,517936269,161285531,67228282,356650738,91269199,977809134,918585062,59224072,241966240,676618822,1180288036,1103120235,77167801,638361097,464759138
Ranthambore,Ranthambore,Ranthambore-Ranthambore,BEN_NW5,BEN_NW6,513216491,468456504,246334233,44759987,222122271,79102006,977809134,918585062,59224072,241966240,676618822,992143483,946435718,45707765,248527765,697907953
Ranthambore,Ranthambore,Ranthambore-Ranthambore,BEN_NW5,BEN_NW8,590187802,539784692,286731419,50403110,253053273,110006105,977809134,918585062,59224072,241966240,676618822,1196839698,1156984240,39855458,275076038,881908202
Ranthambore,Ranthambore,Ranthambore-Ranthambore,BEN_NW5,BEN_NW9,608678093,554415853,323451392,54262240,230964461,90763813,977809134,918585062,59224072,241966240,676618822,1246521228,1203200533,43320695,216389572,986810961
Ranthambore,Ranthambore,Ranthambore-Ranthambore,BEN_NW55,BEN_NW10,710145193,656948170,240023544,53197023,416924626,153134777,1131174741,1073214798,57959943,534097691,539117107,1266198710,1229664069,36534641,328923565,900740504
Ranthambore,Ranthambore,Ranthambore-Ranthambore,BEN_NW55,BEN_NW11,630354706,579089524,246753348,51265182,332336176,136839768,1131174741,1073214798,57959943,534097691,539117107,997123987,950413379,46710608,263905963,686507416
Ranthambore,Ranthambore,Ranthambore-Ranthambore,BEN_NW55,BEN_NW12,706297192,654706943,255627942,51590249,399079001,143695682,1131174741,1073214798,57959943,534097691,539117107,1267506856,1231795407,35711449,227052846,1004742561
Ranthambore,Ranthambore,Ranthambore-Ranthambore,BEN_NW55,BEN_NW13,730701720,673132939,274538089,57568781,398594850,154467816,1131174741,1073214798,57959943,534097691,539117107,1183131254,1138285233,44846021,344174628,794110605
Ranthambore,Ranthambore,Ranthambore-Ranthambore,BEN_NW55,BEN_NW14,722334935,667035224,298311888,55299711,368723336,160875007,1131174741,1073214798,57959943,534097691,539117107,1235716540,1190952996,44763544,177541519,1013411477
Ranthambore,Ranthambore,Ranthambore-Ranthambore,BEN_NW55,BEN_NW17,616639204,571870792,205926655,44768412,365944137,133269005,1131174741,1073214798,57959943,534097691,539117107,1116321554,1085802823,30518731,256140006,829662817
Ranthambore,Ranthambore,Ranthambore-Ranthambore,BEN_NW55,BEN_NW18,785322935,726723439,300268909,58599496,426454530,164033840,1131174741,1073214798,57959943,534097691,539117107,1339364699,1300736006,38628693,242877521,1057858485
Ranthambore,Ranthambore,Ranthambore-Ranthambore,BEN_NW55,BEN_NW19,620987513,568064371,237256430,52923142,330807941,132005954,1131174741,1073214798,57959943,534097691,539117107,1081768306,1036331080,45437226,232322355,804008725
Ranthambore,Ranthambore,Ranthambore-Ranthambore,BEN_NW55,BEN_NW20,633494136,574201856,187035362,59292280,387166494,117918381,1131174741,1073214798,57959943,534097691,539117107,1086271749,1022278981,63992768,541693814,480585167
Ranthambore,Ranthambore,Ranthambore-Ranthambore,BEN_NW55,BEN_NW24,629096628,569988495,213121479,59108133,356867016,134109572,1131174741,1073214798,57959943,534097691,539117107,1159641386,1113494396,46146990,301627698,811866698
Ranthambore,Ranthambore,Ranthambore-Ranthambore,BEN_NW55,BEN_NW3,702780062,645862103,269280768,56917959,376581335,155726406,1131174741,1073214798,57959943,534097691,539117107,1280728709,1240123254,40605455,207797688,1032325566
Ranthambore,Ranthambore,Ranthambore-Ranthambore,BEN_NW55,BEN_NW4,704307169,657716273,315744722,46590896,341971551,159097126,1131174741,1073214798,57959943,534097691,539117107,1219365724,1186222475,33143249,158691252,1027531223
Ranthambore,Ranthambore,Ranthambore-Ranthambore,BEN_NW55,BEN_NW5,607698052,550699358,229640343,56998694,321059015,113604185,1131174741,1073214798,57959943,534097691,539117107,977809134,918585062,59224072,241966240,676618822
Ranthambore,Ranthambore,Ranthambore-Ranthambore,BEN_NW55,BEN_NW57,701335152,632216323,200037172,69118829,432179151,116796088,1131174741,1073214798,57959943,534097691,539117107,1180288036,1103120235,77167801,638361097,464759138
Ranthambore,Ranthambore,Ranthambore-Ranthambore,BEN_NW55,BEN_NW6,684400920,634185498,252518002,50215422,381667496,142950075,1131174741,1073214798,57959943,534097691,539117107,992143483,946435718,45707765,248527765,697907953
Ranthambore,Ranthambore,Ranthambore-Ranthambore,BEN_NW55,BEN_NW8,651386972,598019097,216744581,53367875,381274516,124605644,1131174741,1073214798,57959943,534097691,539117107,1196839698,1156984240,39855458,275076038,881908202
Ranthambore,Ranthambore,Ranthambore-Ranthambore,BEN_NW55,BEN_NW9,687599085,634798768,265420582,52800317,369378186,148555555,1131174741,1073214798,57959943,534097691,539117107,1246521228,1203200533,43320695,216389572,986810961
Ranthambore,Ranthambore,Ranthambore-Ranthambore,BEN_NW57,BEN_NW10,723198929,655225116,207556147,67973813,447668969,136611221,1180288036,1103120235,77167801,638361097,464759138,1266198710,1229664069,36534641,328923565,900740504
Ranthambore,Ranthambore,Ranthambore-Ranthambore,BEN_NW57,BEN_NW11,620340196,560795480,175867369,59544716,384928111,99971196,1180288036,1103120235,77167801,638361097,464759138,997123987,950413379,46710608,263905963,686507416
Ranthambore,Ranthambore,Ranthambore-Ranthambore,BEN_NW57,BEN_NW12,715827266,651872955,218289616,63954311,433583339,123349350,1180288036,1103120235,77167801,638361097,464759138,1267506856,1231795407,35711449,227052846,1004742561
Ranthambore,Ranthambore,Ranthambore-Ranthambore,BEN_NW57,BEN_NW13,698439717,632266755,215673184,66172962,416593571,124014432,1180288036,1103120235,77167801,638361097,464759138,1183131254,1138285233,44846021,344174628,794110605
Ranthambore,Ranthambore,Ranthambore-Ranthambore,BEN_NW57,BEN_NW14,722969706,654846235,236448000,68123471,418398235,129951086,1180288036,1103120235,77167801,638361097,464759138,1235716540,1190952996,44763544,177541519,1013411477
Ranthambore,Ranthambore,Ranthambore-Ranthambore,BEN_NW57,BEN_NW17,645912366,587368094,175723375,58544272,411644719,116671146,1180288036,1103120235,77167801,638361097,464759138,1116321554,1085802823,30518731,256140006,829662817
Ranthambore,Ranthambore,Ranthambore-Ranthambore,BEN_NW57,BEN_NW18,792446832,720420933,245447564,72025899,474973369,156508887,1180288036,1103120235,77167801,638361097,464759138,1339364699,1300736006,38628693,242877521,1057858485
Ranthambore,Ranthambore,Ranthambore-Ranthambore,BEN_NW57,BEN_NW19,632151303,565486191,186751113,66665112,378735078,121018078,1180288036,1103120235,77167801,638361097,464759138,1081768306,1036331080,45437226,232322355,804008725
Ranthambore,Ranthambore,Ranthambore-Ranthambore,BEN_NW57,BEN_NW20,668708667,604990482,204745137,63718185,400245345,128204132,1180288036,1103120235,77167801,638361097,464759138,1086271749,1022278981,63992768,541693814,480585167
Ranthambore,Ranthambore,Ranthambore-Ranthambore,BEN_NW57,BEN_NW24,651947190,579126645,176850235,72820545,402276410,118149265,1180288036,1103120235,77167801,638361097,464759138,1159641386,1113494396,46146990,301627698,811866698
Ranthambore,Ranthambore,Ranthambore-Ranthambore,BEN_NW57,BEN_NW3,727350380,654550269,209818599,72800111,444731670,119540050,1180288036,1103120235,77167801,638361097,464759138,1280728709,1240123254,40605455,207797688,1032325566
Ranthambore,Ranthambore,Ranthambore-Ranthambore,BEN_NW57,BEN_NW4,677613331,617094409,224300437,60518922,392793972,124650674,1180288036,1103120235,77167801,638361097,464759138,1219365724,1186222475,33143249,158691252,1027531223
Ranthambore,Ranthambore,Ranthambore-Ranthambore,BEN_NW57,BEN_NW5,585164551,517936269,161285531,67228282,356650738,91269199,1180288036,1103120235,77167801,638361097,464759138,977809134,918585062,59224072,241966240,676618822
Ranthambore,Ranthambore,Ranthambore-Ranthambore,BEN_NW57,BEN_NW55,701335152,632216323,200037172,69118829,432179151,116796088,1180288036,1103120235,77167801,638361097,464759138,1131174741,1073214798,57959943,534097691,539117107
Ranthambore,Ranthambore,Ranthambore-Ranthambore,BEN_NW57,BEN_NW6,624032256,559451148,171287706,64581108,388163442,117266158,1180288036,1103120235,77167801,638361097,464759138,992143483,946435718,45707765,248527765,697907953
Ranthambore,Ranthambore,Ranthambore-Ranthambore,BEN_NW57,BEN_NW8,668227489,601328329,178245691,66899160,423082638,102267816,1180288036,1103120235,77167801,638361097,464759138,1196839698,1156984240,39855458,275076038,881908202
Ranthambore,Ranthambore,Ranthambore-Ranthambore,BEN_NW57,BEN_NW9,711571066,645364510,203715947,66206556,441648563,123295653,1180288036,1103120235,77167801,638361097,464759138,1246521228,1203200533,43320695,216389572,986810961
Ranthambore,Ranthambore,Ranthambore-Ranthambore,BEN_NW6,BEN_NW10,659034250,616225419,341389446,42808831,274835973,148742961,992143483,946435718,45707765,248527765,697907953,1266198710,1229664069,36534641,328923565,900740504
Ranthambore,Ranthambore,Ranthambore-Ranthambore,BEN_NW6,BEN_NW11,541219990,499629009,268512907,41590981,231116102,105124031,992143483,946435718,45707765,248527765,697907953,997123987,950413379,46710608,263905963,686507416
Ranthambore,Ranthambore,Ranthambore-Ranthambore,BEN_NW6,BEN_NW12,616574984,574519937,333899149,42055047,240620788,118502927,992143483,946435718,45707765,248527765,697907953,1267506856,1231795407,35711449,227052846,1004742561
Ranthambore,Ranthambore,Ranthambore-Ranthambore,BEN_NW6,BEN_NW13,615938511,568647095,287175708,47291416,281471387,128454198,992143483,946435718,45707765,248527765,697907953,1183131254,1138285233,44846021,344174628,794110605
Ranthambore,Ranthambore,Ranthambore-Ranthambore,BEN_NW6,BEN_NW14,657298043,612623273,401135738,44674770,211487535,115600802,992143483,946435718,45707765,248527765,697907953,1235716540,1190952996,44763544,177541519,1013411477
Ranthambore,Ranthambore,Ranthambore-Ranthambore,BEN_NW6,BEN_NW17,584708941,550125614,314261127,34583327,235864487,127900282,992143483,946435718,45707765,248527765,697907953,1116321554,1085802823,30518731,256140006,829662817
Ranthambore,Ranthambore,Ranthambore-Ranthambore,BEN_NW6,BEN_NW18,732586450,691630366,436651805,40956084,254978561,129418900,992143483,946435718,45707765,248527765,697907953,1339364699,1300736006,38628693,242877521,1057858485
Ranthambore,Ranthambore,Ranthambore-Ranthambore,BEN_NW6,BEN_NW19,600816511,559036735,351932541,41779776,207104194,117614837,992143483,946435718,45707765,248527765,697907953,1081768306,1036331080,45437226,232322355,804008725
Ranthambore,Ranthambore,Ranthambore-Ranthambore,BEN_NW6,BEN_NW20,601515069,547846386,206986438,53668683,340859948,126246504,992143483,946435718,45707765,248527765,697907953,1086271749,1022278981,63992768,541693814,480585167
Ranthambore,Ranthambore,Ranthambore-Ranthambore,BEN_NW6,BEN_NW24,561084151,511820820,241821627,49263331,269999193,112293403,992143483,946435718,45707765,248527765,697907953,1159641386,1113494396,46146990,301627698,811866698
Ranthambore,Ranthambore,Ranthambore-Ranthambore,BEN_NW6,BEN_NW3,634509733,589759838,367812536,44749895,221947302,119705506,992143483,946435718,45707765,248527765,697907953,1280728709,1240123254,40605455,207797688,1032325566
Ranthambore,Ranthambore,Ranthambore-Ranthambore,BEN_NW6,BEN_NW4,599187739,561325651,361160829,37862088,200164822,93809818,992143483,946435718,45707765,248527765,697907953,1219365724,1186222475,33143249,158691252,1027531223
Ranthambore,Ranthambore,Ranthambore-Ranthambore,BEN_NW6,BEN_NW5,513216491,468456504,246334233,44759987,222122271,79102006,992143483,946435718,45707765,248527765,697907953,977809134,918585062,59224072,241966240,676618822
Ranthambore,Ranthambore,Ranthambore-Ranthambore,BEN_NW6,BEN_NW55,684400920,634185498,252518002,50215422,381667496,142950075,992143483,946435718,45707765,248527765,697907953,1131174741,1073214798,57959943,534097691,539117107
Ranthambore,Ranthambore,Ranthambore-Ranthambore,BEN_NW6,BEN_NW57,624032256,559451148,171287706,64581108,388163442,117266158,992143483,946435718,45707765,248527765,697907953,1180288036,1103120235,77167801,638361097,464759138
Ranthambore,Ranthambore,Ranthambore-Ranthambore,BEN_NW6,BEN_NW8,575775260,533602105,300343751,42173155,233258354,145177283,992143483,946435718,45707765,248527765,697907953,1196839698,1156984240,39855458,275076038,881908202
Ranthambore,Ranthambore,Ranthambore-Ranthambore,BEN_NW6,BEN_NW9,608985275,564289021,336766573,44696254,227522448,108743969,992143483,946435718,45707765,248527765,697907953,1246521228,1203200533,43320695,216389572,986810961
Ranthambore,Ranthambore,Ranthambore-Ranthambore,BEN_NW8,BEN_NW10,743193523,697603320,365451117,45590203,332152203,190978906,1196839698,1156984240,39855458,275076038,881908202,1266198710,1229664069,36534641,328923565,900740504
Ranthambore,Ranthambore,Ranthambore-Ranthambore,BEN_NW8,BEN_NW11,626612664,581878545,295247413,44734119,286631132,126661848,1196839698,1156984240,39855458,275076038,881908202,997123987,950413379,46710608,263905963,686507416
Ranthambore,Ranthambore,Ranthambore-Ranthambore,BEN_NW8,BEN_NW12,819460428,777899796,491712855,41560632,286186941,169245966,1196839698,1156984240,39855458,275076038,881908202,1267506856,1231795407,35711449,227052846,1004742561
Ranthambore,Ranthambore,Ranthambore-Ranthambore,BEN_NW8,BEN_NW13,731709867,685045805,368736232,46664062,316309573,181942387,1196839698,1156984240,39855458,275076038,881908202,1183131254,1138285233,44846021,344174628,794110605
Ranthambore,Ranthambore,Ranthambore-Ranthambore,BEN_NW8,BEN_NW14,726134344,678613158,438729970,47521186,239883188,154492051,1196839698,1156984240,39855458,275076038,881908202,1235716540,1190952996,44763544,177541519,1013411477
Ranthambore,Ranthambore,Ranthambore-Ranthambore,BEN_NW8,BEN_NW17,670864644,634107492,368864170,36757152,265243322,172321104,1196839698,1156984240,39855458,275076038,881908202,1116321554,1085802823,30518731,256140006,829662817
Ranthambore,Ranthambore,Ranthambore-Ranthambore,BEN_NW8,BEN_NW18,807850666,763529060,472163835,44321606,291365225,181407193,1196839698,1156984240,39855458,275076038,881908202,1339364699,1300736006,38628693,242877521,1057858485
Ranthambore,Ranthambore,Ranthambore-Ranthambore,BEN_NW8,BEN_NW19,660557592,614539981,372571969,46017611,241968012,140945660,1196839698,1156984240,39855458,275076038,881908202,1081768306,1036331080,45437226,232322355,804008725
Ranthambore,Ranthambore,Ranthambore-Ranthambore,BEN_NW8,BEN_NW20,645861910,585551535,192395601,60310375,393155934,114753186,1196839698,1156984240,39855458,275076038,881908202,1086271749,1022278981,63992768,541693814,480585167
Ranthambore,Ranthambore,Ranthambore-Ranthambore,BEN_NW8,BEN_NW24,649051667,596829005,298245582,52222662,298583423,169247491,1196839698,1156984240,39855458,275076038,881908202,1159641386,1113494396,46146990,301627698,811866698
Ranthambore,Ranthambore,Ranthambore-Ranthambore,BEN_NW8,BEN_NW3,681135338,633138326,371242724,47997012,261895602,151691317,1196839698,1156984240,39855458,275076038,881908202,1280728709,1240123254,40605455,207797688,1032325566
Ranthambore,Ranthambore,Ranthambore-Ranthambore,BEN_NW8,BEN_NW4,772408360,732903954,488970871,39504406,243933083,182300188,1196839698,1156984240,39855458,275076038,881908202,1219365724,1186222475,33143249,158691252,1027531223
Ranthambore,Ranthambore,Ranthambore-Ranthambore,BEN_NW8,BEN_NW5,590187802,539784692,286731419,50403110,253053273,110006105,1196839698,1156984240,39855458,275076038,881908202,977809134,918585062,59224072,241966240,676618822
Ranthambore,Ranthambore,Ranthambore-Ranthambore,BEN_NW8,BEN_NW55,651386972,598019097,216744581,53367875,381274516,124605644,1196839698,1156984240,39855458,275076038,881908202,1131174741,1073214798,57959943,534097691,539117107
Ranthambore,Ranthambore,Ranthambore-Ranthambore,BEN_NW8,BEN_NW57,668227489,601328329,178245691,66899160,423082638,102267816,1196839698,1156984240,39855458,275076038,881908202,1180288036,1103120235,77167801,638361097,464759138
Ranthambore,Ranthambore,Ranthambore-Ranthambore,BEN_NW8,BEN_NW6,575775260,533602105,300343751,42173155,233258354,145177283,1196839698,1156984240,39855458,275076038,881908202,992143483,946435718,45707765,248527765,697907953
Ranthambore,Ranthambore,Ranthambore-Ranthambore,BEN_NW8,BEN_NW9,796881647,754576233,477839246,42305414,276736987,172778631,1196839698,1156984240,39855458,275076038,881908202,1246521228,1203200533,43320695,216389572,986810961
Ranthambore,Ranthambore,Ranthambore-Ranthambore,BEN_NW9,BEN_NW10,735863776,688612223,392743277,47251553,295868946,189880681,1246521228,1203200533,43320695,216389572,986810961,1266198710,1229664069,36534641,328923565,900740504
Ranthambore,Ranthambore,Ranthambore-Ranthambore,BEN_NW9,BEN_NW11,677745531,631114174,373171037,46631357,257943137,147203927,1246521228,1203200533,43320695,216389572,986810961,997123987,950413379,46710608,263905963,686507416
Ranthambore,Ranthambore,Ranthambore-Ranthambore,BEN_NW9,BEN_NW12,794027453,750149287,498930156,43878166,251219131,140231257,1246521228,1203200533,43320695,216389572,986810961,1267506856,1231795407,35711449,227052846,1004742561
Ranthambore,Ranthambore,Ranthambore-Ranthambore,BEN_NW9,BEN_NW13,755727190,708122941,401083030,47604249,307039911,172227039,1246521228,1203200533,43320695,216389572,986810961,1183131254,1138285233,44846021,344174628,794110605
Ranthambore,Ranthambore,Ranthambore-Ranthambore,BEN_NW9,BEN_NW14,799384348,750593897,544473971,48790451,206119926,157046725,1246521228,1203200533,43320695,216389572,986810961,1235716540,1190952996,44763544,177541519,1013411477
Ranthambore,Ranthambore,Ranthambore-Ranthambore,BEN_NW9,BEN_NW17,712303342,673829083,417844536,38474259,255984547,151179728,1246521228,1203200533,43320695,216389572,986810961,1116321554,1085802823,30518731,256140006,829662817
Ranthambore,Ranthambore,Ranthambore-Ranthambore,BEN_NW9,BEN_NW18,750518226,699044573,427321021,51473653,271723552,149819232,1246521228,1203200533,43320695,216389572,986810961,1339364699,1300736006,38628693,242877521,1057858485
Ranthambore,Ranthambore,Ranthambore-Ranthambore,BEN_NW9,BEN_NW19,665045026,616045761,378518485,48999265,237527276,103775551,1246521228,1203200533,43320695,216389572,986810961,1081768306,1036331080,45437226,232322355,804008725
Ranthambore,Ranthambore,Ranthambore-Ranthambore,BEN_NW9,BEN_NW20,683582446,624314970,248093688,59267476,376221282,151097777,1246521228,1203200533,43320695,216389572,986810961,1086271749,1022278981,63992768,541693814,480585167
Ranthambore,Ranthambore,Ranthambore-Ranthambore,BEN_NW9,BEN_NW24,695752688,644314621,370659717,51438067,273654904,165467849,1246521228,1203200533,43320695,216389572,986810961,1159641386,1113494396,46146990,301627698,811866698
Ranthambore,Ranthambore,Ranthambore-Ranthambore,BEN_NW9,BEN_NW3,721470794,671803496,419724608,49667298,252078888,109693426,1246521228,1203200533,43320695,216389572,986810961,1280728709,1240123254,40605455,207797688,1032325566
Ranthambore,Ranthambore,Ranthambore-Ranthambore,BEN_NW9,BEN_NW4,861455400,821468808,612362146,39986592,209106662,126446201,1246521228,1203200533,43320695,216389572,986810961,1219365724,1186222475,33143249,158691252,1027531223
Ranthambore,Ranthambore,Ranthambore-Ranthambore,BEN_NW9,BEN_NW5,608678093,554415853,323451392,54262240,230964461,90763813,1246521228,1203200533,43320695,216389572,986810961,977809134,918585062,59224072,241966240,676618822
Ranthambore,Ranthambore,Ranthambore-Ranthambore,BEN_NW9,BEN_NW55,687599085,634798768,265420582,52800317,369378186,148555555,1246521228,1203200533,43320695,216389572,986810961,1131174741,1073214798,57959943,534097691,539117107
Ranthambore,Ranthambore,Ranthambore-Ranthambore,BEN_NW9,BEN_NW57,711571066,645364510,203715947,66206556,441648563,123295653,1246521228,1203200533,43320695,216389572,986810961,1180288036,1103120235,77167801,638361097,464759138
Ranthambore,Ranthambore,Ranthambore-Ranthambore,BEN_NW9,BEN_NW6,608985275,564289021,336766573,44696254,227522448,108743969,1246521228,1203200533,43320695,216389572,986810961,992143483,946435718,45707765,248527765,697907953
Ranthambore,Ranthambore,Ranthambore-Ranthambore,BEN_NW9,BEN_NW8,796881647,754576233,477839246,42305414,276736987,172778631,1246521228,1203200533,43320695,216389572,986810961,1196839698,1156984240,39855458,275076038,881908202
Ranthambore,Wayanad,Ranthambore-Wayanad,BEN_NW10,BEN_SI1,512543106,440071150,171772111,72471956,268299039,104167906,1266198710,1229664069,36534641,328923565,900740504,897358653,799698739,97659914,345341326,454357413
Ranthambore,Wayanad,Ranthambore-Wayanad,BEN_NW10,BEN_SI11,350076720,319921141,121900966,30155579,198020175,56411459,1266198710,1229664069,36534641,328923565,900740504,641166204,612648765,28517439,241001807,371646958
Ranthambore,Wayanad,Ranthambore-Wayanad,BEN_NW10,BEN_SI2,355128743,340625551,182611215,14503192,158014336,92119615,1266198710,1229664069,36534641,328923565,900740504,650993225,648515374,2477851,140667619,507847755
Ranthambore,Wayanad,Ranthambore-Wayanad,BEN_NW10,BEN_SI3,518584010,451307330,181055463,67276680,270251867,116017989,1266198710,1229664069,36534641,328923565,900740504,931565359,847325564,84239795,345974583,501350981
Ranthambore,Wayanad,Ranthambore-Wayanad,BEN_NW10,BEN_SI4,641803010,581269404,289393676,60533606,291875728,122659216,1266198710,1229664069,36534641,328923565,900740504,1109312253,1030580255,78731998,302255092,728325163
Ranthambore,Wayanad,Ranthambore-Wayanad,BEN_NW10,BEN_SI6,529852369,459620272,172947706,70232097,286672566,107021371,1266198710,1229664069,36534641,328923565,900740504,951080464,864453508,86626956,319674486,544779022
Ranthambore,Wayanad,Ranthambore-Wayanad,BEN_NW10,BEN_SI7,522681322,452428201,184580582,70253121,267847619,111971392,1266198710,1229664069,36534641,328923565,900740504,942430262,853584663,88845599,335397181,518187482
Ranthambore,Wayanad,Ranthambore-Wayanad,BEN_NW10,BEN_SI8,641715437,580338933,285492959,61376504,294845974,125402613,1266198710,1229664069,36534641,328923565,900740504,1108177315,1029030472,79146843,300308119,728722353
Ranthambore,Wayanad,Ranthambore-Wayanad,BEN_NW10,BEN_SI9,479572649,403675284,148184575,75897365,255490709,85927616,1266198710,1229664069,36534641,328923565,900740504,849233213,745820153,103413060,339499389,406320764
Ranthambore,Wayanad,Ranthambore-Wayanad,BEN_NW11,BEN_SI1,380659754,314977117,108400791,65682637,206576326,57813624,997123987,950413379,46710608,263905963,686507416,897358653,799698739,97659914,345341326,454357413
Ranthambore,Wayanad,Ranthambore-Wayanad,BEN_NW11,BEN_SI11,276962348,248283286,93383685,28679062,154899601,54596104,997123987,950413379,46710608,263905963,686507416,641166204,612648765,28517439,241001807,371646958
Ranthambore,Wayanad,Ranthambore-Wayanad,BEN_NW11,BEN_SI2,288471378,272375532,150256397,16095846,122119135,73791884,997123987,950413379,46710608,263905963,686507416,650993225,648515374,2477851,140667619,507847755
Ranthambore,Wayanad,Ranthambore-Wayanad,BEN_NW11,BEN_SI3,390159788,331878744,115777501,58281044,216101243,55990906,997123987,950413379,46710608,263905963,686507416,931565359,847325564,84239795,345974583,501350981
Ranthambore,Wayanad,Ranthambore-Wayanad,BEN_NW11,BEN_SI4,503874428,446853976,215456699,57020452,231397277,96675279,997123987,950413379,46710608,263905963,686507416,1109312253,1030580255,78731998,302255092,728325163
Ranthambore,Wayanad,Ranthambore-Wayanad,BEN_NW11,BEN_SI6,408207529,347729737,129917221,60477792,217812516,72999259,997123987,950413379,46710608,263905963,686507416,951080464,864453508,86626956,319674486,544779022
Ranthambore,Wayanad,Ranthambore-Wayanad,BEN_NW11,BEN_SI7,394665289,334066947,118080212,60598342,215986735,51452571,997123987,950413379,46710608,263905963,686507416,942430262,853584663,88845599,335397181,518187482
Ranthambore,Wayanad,Ranthambore-Wayanad,BEN_NW11,BEN_SI8,503121033,445635340,204949104,57485693,240686236,86027739,997123987,950413379,46710608,263905963,686507416,1108177315,1029030472,79146843,300308119,728722353
Ranthambore,Wayanad,Ranthambore-Wayanad,BEN_NW11,BEN_SI9,366404133,304127284,111983431,62276849,192143853,52211458,997123987,950413379,46710608,263905963,686507416,849233213,745820153,103413060,339499389,406320764
Ranthambore,Wayanad,Ranthambore-Wayanad,BEN_NW12,BEN_SI1,543231457,477596551,233320122,65634906,244276429,91393319,1267506856,1231795407,35711449,227052846,1004742561,897358653,799698739,97659914,345341326,454357413
Ranthambore,Wayanad,Ranthambore-Wayanad,BEN_NW12,BEN_SI11,353711476,324582610,143006020,29128866,181576590,62753722,1267506856,1231795407,35711449,227052846,1004742561,641166204,612648765,28517439,241001807,371646958
Ranthambore,Wayanad,Ranthambore-Wayanad,BEN_NW12,BEN_SI2,371986637,360526125,224188909,11460512,136337216,81490517,1267506856,1231795407,35711449,227052846,1004742561,650993225,648515374,2477851,140667619,507847755
Ranthambore,Wayanad,Ranthambore-Wayanad,BEN_NW12,BEN_SI3,528248379,463000088,226346693,65248291,236653395,108003368,1267506856,1231795407,35711449,227052846,1004742561,931565359,847325564,84239795,345974583,501350981
Ranthambore,Wayanad,Ranthambore-Wayanad,BEN_NW12,BEN_SI4,664920669,607768183,360354051,57152486,247414132,100843563,1267506856,1231795407,35711449,227052846,1004742561,1109312253,1030580255,78731998,302255092,728325163
Ranthambore,Wayanad,Ranthambore-Wayanad,BEN_NW12,BEN_SI6,543888530,481992637,211395149,61895893,270597488,87185062,1267506856,1231795407,35711449,227052846,1004742561,951080464,864453508,86626956,319674486,544779022
Ranthambore,Wayanad,Ranthambore-Wayanad,BEN_NW12,BEN_SI7,533679086,465059693,228158126,68619393,236901567,96860374,1267506856,1231795407,35711449,227052846,1004742561,942430262,853584663,88845599,335397181,518187482
Ranthambore,Wayanad,Ranthambore-Wayanad,BEN_NW12,BEN_SI8,664083628,605695781,354383380,58387847,251312401,105307080,1267506856,1231795407,35711449,227052846,1004742561,1108177315,1029030472,79146843,300308119,728722353
Ranthambore,Wayanad,Ranthambore-Wayanad,BEN_NW12,BEN_SI9,494793495,427811989,194960147,66981506,232851842,80735533,1267506856,1231795407,35711449,227052846,1004742561,849233213,745820153,103413060,339499389,406320764
Ranthambore,Wayanad,Ranthambore-Wayanad,BEN_NW13,BEN_SI1,486240534,420814498,163665707,65426036,257148791,106736844,1183131254,1138285233,44846021,344174628,794110605,897358653,799698739,97659914,345341326,454357413
Ranthambore,Wayanad,Ranthambore-Wayanad,BEN_NW13,BEN_SI11,342653946,311846629,136747690,30807317,175098939,79778640,1183131254,1138285233,44846021,344174628,794110605,641166204,612648765,28517439,241001807,371646958
Ranthambore,Wayanad,Ranthambore-Wayanad,BEN_NW13,BEN_SI2,346360075,329476909,162087963,16883166,167388946,72804933,1183131254,1138285233,44846021,344174628,794110605,650993225,648515374,2477851,140667619,507847755
Ranthambore,Wayanad,Ranthambore-Wayanad,BEN_NW13,BEN_SI3,448792283,378823447,117815060,69968836,261008387,82126184,1183131254,1138285233,44846021,344174628,794110605,931565359,847325564,84239795,345974583,501350981
Ranthambore,Wayanad,Ranthambore-Wayanad,BEN_NW13,BEN_SI4,584362337,521957715,232086312,62404622,289871403,104224917,1183131254,1138285233,44846021,344174628,794110605,1109312253,1030580255,78731998,302255092,728325163
Ranthambore,Wayanad,Ranthambore-Wayanad,BEN_NW13,BEN_SI6,495849522,430936691,171787038,64912831,259149653,109205239,1183131254,1138285233,44846021,344174628,794110605,951080464,864453508,86626956,319674486,544779022
Ranthambore,Wayanad,Ranthambore-Wayanad,BEN_NW13,BEN_SI7,452904840,381627249,117112881,71277591,264514368,77483891,1183131254,1138285233,44846021,344174628,794110605,942430262,853584663,88845599,335397181,518187482
Ranthambore,Wayanad,Ranthambore-Wayanad,BEN_NW13,BEN_SI8,583940321,520729826,230813015,63210495,289916811,109354176,1183131254,1138285233,44846021,344174628,794110605,1108177315,1029030472,79146843,300308119,728722353
Ranthambore,Wayanad,Ranthambore-Wayanad,BEN_NW13,BEN_SI9,447369413,377299519,131083635,70069894,246215884,78435826,1183131254,1138285233,44846021,344174628,794110605,849233213,745820153,103413060,339499389,406320764
Ranthambore,Wayanad,Ranthambore-Wayanad,BEN_NW14,BEN_SI1,501134863,433484868,219597980,67649995,213886888,92912899,1235716540,1190952996,44763544,177541519,1013411477,897358653,799698739,97659914,345341326,454357413
Ranthambore,Wayanad,Ranthambore-Wayanad,BEN_NW14,BEN_SI11,347224284,319918333,152645912,27305951,167272421,77161090,1235716540,1190952996,44763544,177541519,1013411477,641166204,612648765,28517439,241001807,371646958
Ranthambore,Wayanad,Ranthambore-Wayanad,BEN_NW14,BEN_SI2,348082366,333640653,202482161,14441713,131158492,66279759,1235716540,1190952996,44763544,177541519,1013411477,650993225,648515374,2477851,140667619,507847755
Ranthambore,Wayanad,Ranthambore-Wayanad,BEN_NW14,BEN_SI3,495077103,429937136,192884267,65139967,237052869,104563247,1235716540,1190952996,44763544,177541519,1013411477,931565359,847325564,84239795,345974583,501350981
Ranthambore,Wayanad,Ranthambore-Wayanad,BEN_NW14,BEN_SI4,673139560,618396704,396686594,54742856,221710110,111311191,1235716540,1190952996,44763544,177541519,1013411477,1109312253,1030580255,78731998,302255092,728325163
Ranthambore,Wayanad,Ranthambore-Wayanad,BEN_NW14,BEN_SI6,527395587,467755477,241006608,59640110,226748869,91706137,1235716540,1190952996,44763544,177541519,1013411477,951080464,864453508,86626956,319674486,544779022
Ranthambore,Wayanad,Ranthambore-Wayanad,BEN_NW14,BEN_SI7,502469072,434267003,197398086,68202069,236868917,93104985,1235716540,1190952996,44763544,177541519,1013411477,942430262,853584663,88845599,335397181,518187482
Ranthambore,Wayanad,Ranthambore-Wayanad,BEN_NW14,BEN_SI8,673920884,618388396,404498216,55532488,213890180,111712917,1235716540,1190952996,44763544,177541519,1013411477,1108177315,1029030472,79146843,300308119,728722353
Ranthambore,Wayanad,Ranthambore-Wayanad,BEN_NW14,BEN_SI9,466531162,398172788,175589577,68358374,222583211,84589306,1235716540,1190952996,44763544,177541519,1013411477,849233213,745820153,103413060,339499389,406320764
Ranthambore,Wayanad,Ranthambore-Wayanad,BEN_NW17,BEN_SI1,437611582,371194102,144113721,66417480,227080381,55506406,1116321554,1085802823,30518731,256140006,829662817,897358653,799698739,97659914,345341326,454357413
Ranthambore,Wayanad,Ranthambore-Wayanad,BEN_NW17,BEN_SI11,317171931,290558875,126921589,26613056,163637286,69245315,1116321554,1085802823,30518731,256140006,829662817,641166204,612648765,28517439,241001807,371646958
Ranthambore,Wayanad,Ranthambore-Wayanad,BEN_NW17,BEN_SI2,304140499,291624894,159290427,12515605,132334467,54652216,1116321554,1085802823,30518731,256140006,829662817,650993225,648515374,2477851,140667619,507847755
Ranthambore,Wayanad,Ranthambore-Wayanad,BEN_NW17,BEN_SI3,472135625,414417788,178828460,57717837,235589328,89061577,1116321554,1085802823,30518731,256140006,829662817,931565359,847325564,84239795,345974583,501350981
Ranthambore,Wayanad,Ranthambore-Wayanad,BEN_NW17,BEN_SI4,588242296,535615928,300416111,52626368,235199817,100321904,1116321554,1085802823,30518731,256140006,829662817,1109312253,1030580255,78731998,302255092,728325163
Ranthambore,Wayanad,Ranthambore-Wayanad,BEN_NW17,BEN_SI6,457189911,393451672,167350354,63738239,226101318,74633892,1116321554,1085802823,30518731,256140006,829662817,951080464,864453508,86626956,319674486,544779022
Ranthambore,Wayanad,Ranthambore-Wayanad,BEN_NW17,BEN_SI7,477717750,417771120,186111772,59946630,231659348,96430067,1116321554,1085802823,30518731,256140006,829662817,942430262,853584663,88845599,335397181,518187482
Ranthambore,Wayanad,Ranthambore-Wayanad,BEN_NW17,BEN_SI8,588128119,534932996,300858279,53195123,234074717,110135496,1116321554,1085802823,30518731,256140006,829662817,1108177315,1029030472,79146843,300308119,728722353
Ranthambore,Wayanad,Ranthambore-Wayanad,BEN_NW17,BEN_SI9,398870601,332709232,107966301,66161369,224742931,63502687,1116321554,1085802823,30518731,256140006,829662817,849233213,745820153,103413060,339499389,406320764
Ranthambore,Wayanad,Ranthambore-Wayanad,BEN_NW18,BEN_SI1,523298002,447973500,174925420,75324502,273048080,82104319,1339364699,1300736006,38628693,242877521,1057858485,897358653,799698739,97659914,345341326,454357413
Ranthambore,Wayanad,Ranthambore-Wayanad,BEN_NW18,BEN_SI11,381501920,352790431,172966813,28711489,179823618,79688767,1339364699,1300736006,38628693,242877521,1057858485,641166204,612648765,28517439,241001807,371646958
Ranthambore,Wayanad,Ranthambore-Wayanad,BEN_NW18,BEN_SI2,337006212,321773085,190636607,15233127,131136478,72385284,1339364699,1300736006,38628693,242877521,1057858485,650993225,648515374,2477851,140667619,507847755
Ranthambore,Wayanad,Ranthambore-Wayanad,BEN_NW18,BEN_SI3,539390937,472472825,207377587,66918112,265095238,107617808,1339364699,1300736006,38628693,242877521,1057858485,931565359,847325564,84239795,345974583,501350981
Ranthambore,Wayanad,Ranthambore-Wayanad,BEN_NW18,BEN_SI4,681703532,620172965,356481004,61530567,263691961,119445526,1339364699,1300736006,38628693,242877521,1057858485,1109312253,1030580255,78731998,302255092,728325163
Ranthambore,Wayanad,Ranthambore-Wayanad,BEN_NW18,BEN_SI6,550680263,480510210,216930464,70170053,263579746,106360613,1339364699,1300736006,38628693,242877521,1057858485,951080464,864453508,86626956,319674486,544779022
Ranthambore,Wayanad,Ranthambore-Wayanad,BEN_NW18,BEN_SI7,545320596,474891205,209420234,70429391,265470971,97914812,1339364699,1300736006,38628693,242877521,1057858485,942430262,853584663,88845599,335397181,518187482
Ranthambore,Wayanad,Ranthambore-Wayanad,BEN_NW18,BEN_SI8,681851613,618070220,360570091,63781393,257500129,130199564,1339364699,1300736006,38628693,242877521,1057858485,1108177315,1029030472,79146843,300308119,728722353
Ranthambore,Wayanad,Ranthambore-Wayanad,BEN_NW18,BEN_SI9,509939637,434558349,190422256,75381288,244136093,82963542,1339364699,1300736006,38628693,242877521,1057858485,849233213,745820153,103413060,339499389,406320764
Ranthambore,Wayanad,Ranthambore-Wayanad,BEN_NW19,BEN_SI1,434193281,365423023,162627552,68770258,202795471,67304384,1081768306,1036331080,45437226,232322355,804008725,897358653,799698739,97659914,345341326,454357413
Ranthambore,Wayanad,Ranthambore-Wayanad,BEN_NW19,BEN_SI11,306049153,277261489,120062613,28787664,157198876,51951259,1081768306,1036331080,45437226,232322355,804008725,641166204,612648765,28517439,241001807,371646958
Ranthambore,Wayanad,Ranthambore-Wayanad,BEN_NW19,BEN_SI2,290813046,274700941,150667226,16112105,124033715,48119671,1081768306,1036331080,45437226,232322355,804008725,650993225,648515374,2477851,140667619,507847755
Ranthambore,Wayanad,Ranthambore-Wayanad,BEN_NW19,BEN_SI3,414767543,348897716,134077890,65869827,214819826,68280152,1081768306,1036331080,45437226,232322355,804008725,931565359,847325564,84239795,345974583,501350981
Ranthambore,Wayanad,Ranthambore-Wayanad,BEN_NW19,BEN_SI4,559861608,501692829,284021837,58168779,217670992,99333503,1081768306,1036331080,45437226,232322355,804008725,1109312253,1030580255,78731998,302255092,728325163
Ranthambore,Wayanad,Ranthambore-Wayanad,BEN_NW19,BEN_SI6,460334811,398275322,198160659,62059489,200114663,74814069,1081768306,1036331080,45437226,232322355,804008725,951080464,864453508,86626956,319674486,544779022
Ranthambore,Wayanad,Ranthambore-Wayanad,BEN_NW19,BEN_SI7,421952602,353487521,133929172,68465081,219558349,63306283,1081768306,1036331080,45437226,232322355,804008725,942430262,853584663,88845599,335397181,518187482
Ranthambore,Wayanad,Ranthambore-Wayanad,BEN_NW19,BEN_SI8,559574048,500849542,280811423,58724506,220038119,101386846,1081768306,1036331080,45437226,232322355,804008725,1108177315,1029030472,79146843,300308119,728722353
Ranthambore,Wayanad,Ranthambore-Wayanad,BEN_NW19,BEN_SI9,390675662,320630560,117237783,70045102,203392777,41142282,1081768306,1036331080,45437226,232322355,804008725,849233213,745820153,103413060,339499389,406320764
Ranthambore,Wayanad,Ranthambore-Wayanad,BEN_NW20,BEN_SI1,422423946,341812350,63098067,80611596,278714283,55422180,1086271749,1022278981,63992768,541693814,480585167,897358653,799698739,97659914,345341326,454357413
Ranthambore,Wayanad,Ranthambore-Wayanad,BEN_NW20,BEN_SI11,307995544,269419479,58049556,38576065,211369923,43102464,1086271749,1022278981,63992768,541693814,480585167,641166204,612648765,28517439,241001807,371646958
Ranthambore,Wayanad,Ranthambore-Wayanad,BEN_NW20,BEN_SI2,275124613,251026892,66856005,24097721,184170887,51736732,1086271749,1022278981,63992768,541693814,480585167,650993225,648515374,2477851,140667619,507847755
Ranthambore,Wayanad,Ranthambore-Wayanad,BEN_NW20,BEN_SI3,438074340,363617974,98603958,74456366,265014016,70989987,1086271749,1022278981,63992768,541693814,480585167,931565359,847325564,84239795,345974583,501350981
Ranthambore,Wayanad,Ranthambore-Wayanad,BEN_NW20,BEN_SI4,573487235,501130254,173971699,72356981,327158555,122021172,1086271749,1022278981,63992768,541693814,480585167,1109312253,1030580255,78731998,302255092,728325163
Ranthambore,Wayanad,Ranthambore-Wayanad,BEN_NW20,BEN_SI6,475579348,403921781,129141144,71657567,274780637,92902780,1086271749,1022278981,63992768,541693814,480585167,951080464,864453508,86626956,319674486,544779022
Ranthambore,Wayanad,Ranthambore-Wayanad,BEN_NW20,BEN_SI7,442835378,366051871,90924894,76783507,275126977,60025892,1086271749,1022278981,63992768,541693814,480585167,942430262,853584663,88845599,335397181,518187482
Ranthambore,Wayanad,Ranthambore-Wayanad,BEN_NW20,BEN_SI8,574521281,502385493,176274661,72135788,326110832,137151671,1086271749,1022278981,63992768,541693814,480585167,1108177315,1029030472,79146843,300308119,728722353
Ranthambore,Wayanad,Ranthambore-Wayanad,BEN_NW20,BEN_SI9,400691623,319161072,90338129,81530551,228822943,62234594,1086271749,1022278981,63992768,541693814,480585167,849233213,745820153,103413060,339499389,406320764
Ranthambore,Wayanad,Ranthambore-Wayanad,BEN_NW24,BEN_SI1,461232675,390048637,146511676,71184038,243536961,72212855,1159641386,1113494396,46146990,301627698,811866698,897358653,799698739,97659914,345341326,454357413
Ranthambore,Wayanad,Ranthambore-Wayanad,BEN_NW24,BEN_SI11,339778463,311512320,121174909,28266143,190337411,74507487,1159641386,1113494396,46146990,301627698,811866698,641166204,612648765,28517439,241001807,371646958
Ranthambore,Wayanad,Ranthambore-Wayanad,BEN_NW24,BEN_SI2,323693026,306448457,147061908,17244569,159386549,84317447,1159641386,1113494396,46146990,301627698,811866698,650993225,648515374,2477851,140667619,507847755
Ranthambore,Wayanad,Ranthambore-Wayanad,BEN_NW24,BEN_SI3,501879309,439701105,186438722,62178204,253262383,89493052,1159641386,1113494396,46146990,301627698,811866698,931565359,847325564,84239795,345974583,501350981
Ranthambore,Wayanad,Ranthambore-Wayanad,BEN_NW24,BEN_SI4,577223605,516204693,233508995,61018912,282695698,117042287,1159641386,1113494396,46146990,301627698,811866698,1109312253,1030580255,78731998,302255092,728325163
Ranthambore,Wayanad,Ranthambore-Wayanad,BEN_NW24,BEN_SI6,500691089,436661971,190109681,64029118,246552290,75651418,1159641386,1113494396,46146990,301627698,811866698,951080464,864453508,86626956,319674486,544779022
Ranthambore,Wayanad,Ranthambore-Wayanad,BEN_NW24,BEN_SI7,507343035,443802413,192644895,63540622,251157518,91136878,1159641386,1113494396,46146990,301627698,811866698,942430262,853584663,88845599,335397181,518187482
Ranthambore,Wayanad,Ranthambore-Wayanad,BEN_NW24,BEN_SI8,577960719,515434937,247674789,62525782,267760148,118704603,1159641386,1113494396,46146990,301627698,811866698,1108177315,1029030472,79146843,300308119,728722353
Ranthambore,Wayanad,Ranthambore-Wayanad,BEN_NW24,BEN_SI9,431773837,358835215,119959850,72938622,238875365,78495122,1159641386,1113494396,46146990,301627698,811866698,849233213,745820153,103413060,339499389,406320764
Ranthambore,Wayanad,Ranthambore-Wayanad,BEN_NW3,BEN_SI1,533469953,464998704,226857794,68471249,238140910,83421096,1280728709,1240123254,40605455,207797688,1032325566,897358653,799698739,97659914,345341326,454357413
Ranthambore,Wayanad,Ranthambore-Wayanad,BEN_NW3,BEN_SI11,358130276,330088854,163942491,28041422,166146363,66161105,1280728709,1240123254,40605455,207797688,1032325566,641166204,612648765,28517439,241001807,371646958
Ranthambore,Wayanad,Ranthambore-Wayanad,BEN_NW3,BEN_SI2,342808555,326872947,202239619,15935608,124633328,74882352,1280728709,1240123254,40605455,207797688,1032325566,650993225,648515374,2477851,140667619,507847755
Ranthambore,Wayanad,Ranthambore-Wayanad,BEN_NW3,BEN_SI3,505091834,437745322,189958065,67346512,247787257,80736101,1280728709,1240123254,40605455,207797688,1032325566,931565359,847325564,84239795,345974583,501350981
Ranthambore,Wayanad,Ranthambore-Wayanad,BEN_NW3,BEN_SI4,603750966,536485599,278217407,67265367,258268192,84632238,1280728709,1240123254,40605455,207797688,1032325566,1109312253,1030580255,78731998,302255092,728325163
Ranthambore,Wayanad,Ranthambore-Wayanad,BEN_NW3,BEN_SI6,555466075,489731931,253428533,65734144,236303398,96533377,1280728709,1240123254,40605455,207797688,1032325566,951080464,864453508,86626956,319674486,544779022
Ranthambore,Wayanad,Ranthambore-Wayanad,BEN_NW3,BEN_SI7,511743705,441187898,199201563,70555807,241986335,74227046,1280728709,1240123254,40605455,207797688,1032325566,942430262,853584663,88845599,335397181,518187482
Ranthambore,Wayanad,Ranthambore-Wayanad,BEN_NW3,BEN_SI8,603561150,535369304,272377005,68191846,262992299,92398500,1280728709,1240123254,40605455,207797688,1032325566,1108177315,1029030472,79146843,300308119,728722353
Ranthambore,Wayanad,Ranthambore-Wayanad,BEN_NW3,BEN_SI9,494485979,422111022,197809709,72374957,224301313,85614475,1280728709,1240123254,40605455,207797688,1032325566,849233213,745820153,103413060,339499389,406320764
Ranthambore,Wayanad,Ranthambore-Wayanad,BEN_NW4,BEN_SI1,468258269,405569272,184492554,62688997,221076718,67665473,1219365724,1186222475,33143249,158691252,1027531223,897358653,799698739,97659914,345341326,454357413
Ranthambore,Wayanad,Ranthambore-Wayanad,BEN_NW4,BEN_SI11,324377247,301612892,139014956,22764355,162597936,59044044,1219365724,1186222475,33143249,158691252,1027531223,641166204,612648765,28517439,241001807,371646958
Ranthambore,Wayanad,Ranthambore-Wayanad,BEN_NW4,BEN_SI2,336118269,324284237,213214984,11834032,111069253,54627432,1219365724,1186222475,33143249,158691252,1027531223,650993225,648515374,2477851,140667619,507847755
Ranthambore,Wayanad,Ranthambore-Wayanad,BEN_NW4,BEN_SI3,492849669,435252381,205424694,57597288,229827687,74056501,1219365724,1186222475,33143249,158691252,1027531223,931565359,847325564,84239795,345974583,501350981
Ranthambore,Wayanad,Ranthambore-Wayanad,BEN_NW4,BEN_SI4,617252251,562704496,337917126,54547755,224787370,102269888,1219365724,1186222475,33143249,158691252,1027531223,1109312253,1030580255,78731998,302255092,728325163
Ranthambore,Wayanad,Ranthambore-Wayanad,BEN_NW4,BEN_SI6,522054711,466343642,246800565,55711069,219543077,79508939,1219365724,1186222475,33143249,158691252,1027531223,951080464,864453508,86626956,319674486,544779022
Ranthambore,Wayanad,Ranthambore-Wayanad,BEN_NW4,BEN_SI7,498234703,437073919,209354920,61160784,227718999,68477292,1219365724,1186222475,33143249,158691252,1027531223,942430262,853584663,88845599,335397181,518187482
Ranthambore,Wayanad,Ranthambore-Wayanad,BEN_NW4,BEN_SI8,616835015,561936888,338511570,54898127,223425318,98841192,1219365724,1186222475,33143249,158691252,1027531223,1108177315,1029030472,79146843,300308119,728722353
Ranthambore,Wayanad,Ranthambore-Wayanad,BEN_NW4,BEN_SI9,469698849,404550356,200573195,65148493,203977161,66846137,1219365724,1186222475,33143249,158691252,1027531223,849233213,745820153,103413060,339499389,406320764
Ranthambore,Wayanad,Ranthambore-Wayanad,BEN_NW5,BEN_SI1,379815641,313069836,100762692,66745805,212307144,63294247,977809134,918585062,59224072,241966240,676618822,897358653,799698739,97659914,345341326,454357413
Ranthambore,Wayanad,Ranthambore-Wayanad,BEN_NW5,BEN_SI11,264730357,235964578,89526493,28765779,146438085,45982345,977809134,918585062,59224072,241966240,676618822,641166204,612648765,28517439,241001807,371646958
Ranthambore,Wayanad,Ranthambore-Wayanad,BEN_NW5,BEN_SI2,278046174,258963278,134216773,19082896,124746505,56496839,977809134,918585062,59224072,241966240,676618822,650993225,648515374,2477851,140667619,507847755
Ranthambore,Wayanad,Ranthambore-Wayanad,BEN_NW5,BEN_SI3,361942121,297503679,96795398,64438442,200708281,63201653,977809134,918585062,59224072,241966240,676618822,931565359,847325564,84239795,345974583,501350981
Ranthambore,Wayanad,Ranthambore-Wayanad,BEN_NW5,BEN_SI4,477142389,414714597,193281987,62427792,221432610,77032492,977809134,918585062,59224072,241966240,676618822,1109312253,1030580255,78731998,302255092,728325163
Ranthambore,Wayanad,Ranthambore-Wayanad,BEN_NW5,BEN_SI6,399194758,336533289,150234816,62661469,186298473,59718291,977809134,918585062,59224072,241966240,676618822,951080464,864453508,86626956,319674486,544779022
Ranthambore,Wayanad,Ranthambore-Wayanad,BEN_NW5,BEN_SI7,366426121,299767780,98747282,66658341,201020498,59650175,977809134,918585062,59224072,241966240,676618822,942430262,853584663,88845599,335397181,518187482
Ranthambore,Wayanad,Ranthambore-Wayanad,BEN_NW5,BEN_SI8,476287141,413022603,195433864,63264538,217588739,75308319,977809134,918585062,59224072,241966240,676618822,1108177315,1029030472,79146843,300308119,728722353
Ranthambore,Wayanad,Ranthambore-Wayanad,BEN_NW5,BEN_SI9,351863104,283492948,98790934,68370156,184702014,50112188,977809134,918585062,59224072,241966240,676618822,849233213,745820153,103413060,339499389,406320764
Ranthambore,Wayanad,Ranthambore-Wayanad,BEN_NW55,BEN_SI1,439250034,360854884,82007387,78395150,278847497,68114357,1131174741,1073214798,57959943,534097691,539117107,897358653,799698739,97659914,345341326,454357413
Ranthambore,Wayanad,Ranthambore-Wayanad,BEN_NW55,BEN_SI11,316103642,278700452,63535757,37403190,215164695,46456402,1131174741,1073214798,57959943,534097691,539117107,641166204,612648765,28517439,241001807,371646958
Ranthambore,Wayanad,Ranthambore-Wayanad,BEN_NW55,BEN_SI2,321268881,299599006,118689992,21669875,180909014,63167284,1131174741,1073214798,57959943,534097691,539117107,650993225,648515374,2477851,140667619,507847755
Ranthambore,Wayanad,Ranthambore-Wayanad,BEN_NW55,BEN_SI3,453661204,378795485,104860176,74865719,273935309,79936974,1131174741,1073214798,57959943,534097691,539117107,931565359,847325564,84239795,345974583,501350981
Ranthambore,Wayanad,Ranthambore-Wayanad,BEN_NW55,BEN_SI4,591694831,522539258,183441573,69155573,339097685,101565324,1131174741,1073214798,57959943,534097691,539117107,1109312253,1030580255,78731998,302255092,728325163
Ranthambore,Wayanad,Ranthambore-Wayanad,BEN_NW55,BEN_SI6,491348749,416910120,143929522,74438629,272980598,95786057,1131174741,1073214798,57959943,534097691,539117107,951080464,864453508,86626956,319674486,544779022
Ranthambore,Wayanad,Ranthambore-Wayanad,BEN_NW55,BEN_SI7,459317131,382525359,101155109,76791772,281370250,75327834,1131174741,1073214798,57959943,534097691,539117107,942430262,853584663,88845599,335397181,518187482
Ranthambore,Wayanad,Ranthambore-Wayanad,BEN_NW55,BEN_SI8,592219507,522497651,180622446,69721856,341875205,104044676,1131174741,1073214798,57959943,534097691,539117107,1108177315,1029030472,79146843,300308119,728722353
Ranthambore,Wayanad,Ranthambore-Wayanad,BEN_NW55,BEN_SI9,427374124,350877700,90425739,76496424,260451961,62843894,1131174741,1073214798,57959943,534097691,539117107,849233213,745820153,103413060,339499389,406320764
Ranthambore,Wayanad,Ranthambore-Wayanad,BEN_NW57,BEN_SI1,462943169,371714118,78805679,91229051,292908439,58964000,1180288036,1103120235,77167801,638361097,464759138,897358653,799698739,97659914,345341326,454357413
Ranthambore,Wayanad,Ranthambore-Wayanad,BEN_NW57,BEN_SI11,317512474,270058433,45315348,47454041,224743085,31665586,1180288036,1103120235,77167801,638361097,464759138,641166204,612648765,28517439,241001807,371646958
Ranthambore,Wayanad,Ranthambore-Wayanad,BEN_NW57,BEN_SI2,327345823,297535543,84127727,29810280,213407816,57437954,1180288036,1103120235,77167801,638361097,464759138,650993225,648515374,2477851,140667619,507847755
Ranthambore,Wayanad,Ranthambore-Wayanad,BEN_NW57,BEN_SI3,482421156,398459132,94810270,83962024,303648862,64166470,1180288036,1103120235,77167801,638361097,464759138,931565359,847325564,84239795,345974583,501350981
Ranthambore,Wayanad,Ranthambore-Wayanad,BEN_NW57,BEN_SI4,619136443,538127593,175456990,81008850,362670603,112267095,1180288036,1103120235,77167801,638361097,464759138,1109312253,1030580255,78731998,302255092,728325163
Ranthambore,Wayanad,Ranthambore-Wayanad,BEN_NW57,BEN_SI6,515526628,431712221,112424027,83814407,319288194,81278595,1180288036,1103120235,77167801,638361097,464759138,951080464,864453508,86626956,319674486,544779022
Ranthambore,Wayanad,Ranthambore-Wayanad,BEN_NW57,BEN_SI7,487912630,400121346,90607083,87791284,309514263,57849979,1180288036,1103120235,77167801,638361097,464759138,942430262,853584663,88845599,335397181,518187482
Ranthambore,Wayanad,Ranthambore-Wayanad,BEN_NW57,BEN_SI8,619270592,538634861,175336944,80635731,363297917,108542298,1180288036,1103120235,77167801,638361097,464759138,1108177315,1029030472,79146843,300308119,728722353
Ranthambore,Wayanad,Ranthambore-Wayanad,BEN_NW57,BEN_SI9,442886549,353452868,80669897,89433681,272782971,64162278,1180288036,1103120235,77167801,638361097,464759138,849233213,745820153,103413060,339499389,406320764
Ranthambore,Wayanad,Ranthambore-Wayanad,BEN_NW6,BEN_SI1,373415442,309307419,94248377,64108023,215059042,45189743,992143483,946435718,45707765,248527765,697907953,897358653,799698739,97659914,345341326,454357413
Ranthambore,Wayanad,Ranthambore-Wayanad,BEN_NW6,BEN_SI11,266846457,239076296,85949475,27770161,153126821,48621815,992143483,946435718,45707765,248527765,697907953,641166204,612648765,28517439,241001807,371646958
Ranthambore,Wayanad,Ranthambore-Wayanad,BEN_NW6,BEN_SI2,268852899,252574798,129420818,16278101,123153980,55152701,992143483,946435718,45707765,248527765,697907953,650993225,648515374,2477851,140667619,507847755
Ranthambore,Wayanad,Ranthambore-Wayanad,BEN_NW6,BEN_SI3,410223214,351328054,147524362,58895160,203803692,73411379,992143483,946435718,45707765,248527765,697907953,931565359,847325564,84239795,345974583,501350981
Ranthambore,Wayanad,Ranthambore-Wayanad,BEN_NW6,BEN_SI4,504277770,448997253,222843285,55280517,226153968,78957567,992143483,946435718,45707765,248527765,697907953,1109312253,1030580255,78731998,302255092,728325163
Ranthambore,Wayanad,Ranthambore-Wayanad,BEN_NW6,BEN_SI6,404089623,345215000,128938331,58874623,216276669,70872872,992143483,946435718,45707765,248527765,697907953,951080464,864453508,86626956,319674486,544779022
Ranthambore,Wayanad,Ranthambore-Wayanad,BEN_NW6,BEN_SI7,415628155,354170254,139728727,61457901,214441527,65607771,992143483,946435718,45707765,248527765,697907953,942430262,853584663,88845599,335397181,518187482
Ranthambore,Wayanad,Ranthambore-Wayanad,BEN_NW6,BEN_SI8,504552782,449508797,220193683,55043985,229315114,77991213,992143483,946435718,45707765,248527765,697907953,1108177315,1029030472,79146843,300308119,728722353
Ranthambore,Wayanad,Ranthambore-Wayanad,BEN_NW6,BEN_SI9,394960320,333595544,143815786,61364776,189779758,55627440,992143483,946435718,45707765,248527765,697907953,849233213,745820153,103413060,339499389,406320764
Ranthambore,Wayanad,Ranthambore-Wayanad,BEN_NW8,BEN_SI1,471686030,400717936,154252888,70968094,246465048,78126715,1196839698,1156984240,39855458,275076038,881908202,897358653,799698739,97659914,345341326,454357413
Ranthambore,Wayanad,Ranthambore-Wayanad,BEN_NW8,BEN_SI11,346304553,316523895,133225837,29780658,183298058,68692234,1196839698,1156984240,39855458,275076038,881908202,641166204,612648765,28517439,241001807,371646958
Ranthambore,Wayanad,Ranthambore-Wayanad,BEN_NW8,BEN_SI2,344874076,329725217,180597702,15148859,149127515,92641231,1196839698,1156984240,39855458,275076038,881908202,650993225,648515374,2477851,140667619,507847755
Ranthambore,Wayanad,Ranthambore-Wayanad,BEN_NW8,BEN_SI3,492863905,425518855,187121582,67345050,238397273,92804245,1196839698,1156984240,39855458,275076038,881908202,931565359,847325564,84239795,345974583,501350981
Ranthambore,Wayanad,Ranthambore-Wayanad,BEN_NW8,BEN_SI4,594368843,530955346,266196633,63413497,264758713,106850961,1196839698,1156984240,39855458,275076038,881908202,1109312253,1030580255,78731998,302255092,728325163
Ranthambore,Wayanad,Ranthambore-Wayanad,BEN_NW8,BEN_SI6,486130973,420942897,179529124,65188076,241413773,82731871,1196839698,1156984240,39855458,275076038,881908202,951080464,864453508,86626956,319674486,544779022
Ranthambore,Wayanad,Ranthambore-Wayanad,BEN_NW8,BEN_SI7,498001144,428107216,196260888,69893928,231846328,93641720,1196839698,1156984240,39855458,275076038,881908202,942430262,853584663,88845599,335397181,518187482
Ranthambore,Wayanad,Ranthambore-Wayanad,BEN_NW8,BEN_SI8,593145911,529282194,261514502,63863717,267767692,109126223,1196839698,1156984240,39855458,275076038,881908202,1108177315,1029030472,79146843,300308119,728722353
Ranthambore,Wayanad,Ranthambore-Wayanad,BEN_NW8,BEN_SI9,460725000,391802523,162745390,68922477,229057133,62523331,1196839698,1156984240,39855458,275076038,881908202,849233213,745820153,103413060,339499389,406320764
Ranthambore,Wayanad,Ranthambore-Wayanad,BEN_NW9,BEN_SI1,496244003,424789789,192160130,71454214,232629659,92491097,1246521228,1203200533,43320695,216389572,986810961,897358653,799698739,97659914,345341326,454357413
Ranthambore,Wayanad,Ranthambore-Wayanad,BEN_NW9,BEN_SI11,331057283,301001321,121727282,30055962,179274039,68926424,1246521228,1203200533,43320695,216389572,986810961,641166204,612648765,28517439,241001807,371646958
Ranthambore,Wayanad,Ranthambore-Wayanad,BEN_NW9,BEN_SI2,346486042,330989767,202897730,15496275,128092037,66009504,1246521228,1203200533,43320695,216389572,986810961,650993225,648515374,2477851,140667619,507847755
Ranthambore,Wayanad,Ranthambore-Wayanad,BEN_NW9,BEN_SI3,495557572,428019537,192321066,67538035,235698471,86447332,1246521228,1203200533,43320695,216389572,986810961,931565359,847325564,84239795,345974583,501350981
Ranthambore,Wayanad,Ranthambore-Wayanad,BEN_NW9,BEN_SI4,618626280,554888537,296914125,63737743,257974412,116934978,1246521228,1203200533,43320695,216389572,986810961,1109312253,1030580255,78731998,302255092,728325163
Ranthambore,Wayanad,Ranthambore-Wayanad,BEN_NW9,BEN_SI6,528075466,464945295,224577798,63130171,240367497,96834145,1246521228,1203200533,43320695,216389572,986810961,951080464,864453508,86626956,319674486,544779022
Ranthambore,Wayanad,Ranthambore-Wayanad,BEN_NW9,BEN_SI7,501042046,431137614,194729200,69904432,236408414,74835113,1246521228,1203200533,43320695,216389572,986810961,942430262,853584663,88845599,335397181,518187482
Ranthambore,Wayanad,Ranthambore-Wayanad,BEN_NW9,BEN_SI8,616979389,553149027,287325577,63830362,265823450,112722176,1246521228,1203200533,43320695,216389572,986810961,1108177315,1029030472,79146843,300308119,728722353
Ranthambore,Wayanad,Ranthambore-Wayanad,BEN_NW9,BEN_SI9,464939502,393266153,179612344,71673349,213653809,81966155,1246521228,1203200533,43320695,216389572,986810961,849233213,745820153,103413060,339499389,406320764
Ranthambore,Zoo,Ranthambore-Zoo,BEN_NW10,ZSB_01,412244260,348095127,147670784,64149133,200424343,66109362,1266198710,1229664069,36534641,328923565,900740504,723092447,635855373,87237074,256023333,379832040
Ranthambore,Zoo,Ranthambore-Zoo,BEN_NW10,ZSB_02,558525659,502757246,271108411,55768413,231648835,134151548,1266198710,1229664069,36534641,328923565,900740504,942790346,865053483,77736863,260820720,604232763
Ranthambore,Zoo,Ranthambore-Zoo,BEN_NW10,ZSB_03,521577343,469560150,238744359,52017193,230815791,118589100,1266198710,1229664069,36534641,328923565,900740504,892317758,827799945,64517813,241409256,586390689
Ranthambore,Zoo,Ranthambore-Zoo,BEN_NW10,ZSB_04,536881342,487149256,247699617,49732086,239449639,138253129,1266198710,1229664069,36534641,328923565,900740504,867386629,799476794,67909835,302302125,497174669
Ranthambore,Zoo,Ranthambore-Zoo,BEN_NW10,ZSB_05,488681283,426913722,207344798,61767561,219568924,119692607,1266198710,1229664069,36534641,328923565,900740504,864922054,784467789,80454265,246263826,538203963
Ranthambore,Zoo,Ranthambore-Zoo,BEN_NW11,ZSB_01,335241250,282454267,134209280,52786983,148244987,49893780,997123987,950413379,46710608,263905963,686507416,723092447,635855373,87237074,256023333,379832040
Ranthambore,Zoo,Ranthambore-Zoo,BEN_NW11,ZSB_02,474025532,426755316,238683116,47270216,188072200,103642038,997123987,950413379,46710608,263905963,686507416,942790346,865053483,77736863,260820720,604232763
Ranthambore,Zoo,Ranthambore-Zoo,BEN_NW11,ZSB_03,411299396,365904998,203437588,45394398,162467410,76894977,997123987,950413379,46710608,263905963,686507416,892317758,827799945,64517813,241409256,586390689
Ranthambore,Zoo,Ranthambore-Zoo,BEN_NW11,ZSB_04,392679127,344179543,151724121,48499584,192455422,81040824,997123987,950413379,46710608,263905963,686507416,867386629,799476794,67909835,302302125,497174669
Ranthambore,Zoo,Ranthambore-Zoo,BEN_NW11,ZSB_05,357470120,300402937,124432267,57067183,175970670,71296521,997123987,950413379,46710608,263905963,686507416,864922054,784467789,80454265,246263826,538203963
Ranthambore,Zoo,Ranthambore-Zoo,BEN_NW12,ZSB_01,424432197,362263863,184952064,62168334,177311799,62673224,1267506856,1231795407,35711449,227052846,1004742561,723092447,635855373,87237074,256023333,379832040
Ranthambore,Zoo,Ranthambore-Zoo,BEN_NW12,ZSB_02,544639745,489674580,280218647,54965165,209455933,100162190,1267506856,1231795407,35711449,227052846,1004742561,942790346,865053483,77736863,260820720,604232763
Ranthambore,Zoo,Ranthambore-Zoo,BEN_NW12,ZSB_03,479314741,426932204,223648745,52382537,203283459,82159637,1267506856,1231795407,35711449,227052846,1004742561,892317758,827799945,64517813,241409256,586390689
Ranthambore,Zoo,Ranthambore-Zoo,BEN_NW12,ZSB_04,492735576,442923062,223105595,49812514,219817467,117669219,1267506856,1231795407,35711449,227052846,1004742561,867386629,799476794,67909835,302302125,497174669
Ranthambore,Zoo,Ranthambore-Zoo,BEN_NW12,ZSB_05,508767054,451206185,255852487,57560869,195353698,77302884,1267506856,1231795407,35711449,227052846,1004742561,864922054,784467789,80454265,246263826,538203963
Ranthambore,Zoo,Ranthambore-Zoo,BEN_NW13,ZSB_01,397413811,338713492,149365805,58700319,189347687,60131539,1183131254,1138285233,44846021,344174628,794110605,723092447,635855373,87237074,256023333,379832040
Ranthambore,Zoo,Ranthambore-Zoo,BEN_NW13,ZSB_02,520040693,460791241,236081886,59249452,224709355,121985722,1183131254,1138285233,44846021,344174628,794110605,942790346,865053483,77736863,260820720,604232763
Ranthambore,Zoo,Ranthambore-Zoo,BEN_NW13,ZSB_03,467298624,415114947,183659520,52183677,231455427,102291318,1183131254,1138285233,44846021,344174628,794110605,892317758,827799945,64517813,241409256,586390689
Ranthambore,Zoo,Ranthambore-Zoo,BEN_NW13,ZSB_04,485695287,430369916,194303745,55325371,236066171,115392585,1183131254,1138285233,44846021,344174628,794110605,867386629,799476794,67909835,302302125,497174669
Ranthambore,Zoo,Ranthambore-Zoo,BEN_NW13,ZSB_05,457614336,396719502,173821810,60894834,222897692,98246454,1183131254,1138285233,44846021,344174628,794110605,864922054,784467789,80454265,246263826,538203963
Ranthambore,Zoo,Ranthambore-Zoo,BEN_NW14,ZSB_01,382537880,320107484,162071369,62430396,158036115,44712774,1235716540,1190952996,44763544,177541519,1013411477,723092447,635855373,87237074,256023333,379832040
Ranthambore,Zoo,Ranthambore-Zoo,BEN_NW14,ZSB_02,549764487,492730326,289991680,57034161,202738646,105253413,1235716540,1190952996,44763544,177541519,1013411477,942790346,865053483,77736863,260820720,604232763
Ranthambore,Zoo,Ranthambore-Zoo,BEN_NW14,ZSB_03,503381127,453218094,266261159,50163033,186956935,80293008,1235716540,1190952996,44763544,177541519,1013411477,892317758,827799945,64517813,241409256,586390689
Ranthambore,Zoo,Ranthambore-Zoo,BEN_NW14,ZSB_04,487729675,434776795,226667995,52952880,208108800,99415504,1235716540,1190952996,44763544,177541519,1013411477,867386629,799476794,67909835,302302125,497174669
Ranthambore,Zoo,Ranthambore-Zoo,BEN_NW14,ZSB_05,440285690,377982365,191237809,62303325,186744556,54792659,1235716540,1190952996,44763544,177541519,1013411477,864922054,784467789,80454265,246263826,538203963
Ranthambore,Zoo,Ranthambore-Zoo,BEN_NW17,ZSB_01,337206481,280887245,113686341,56319236,167200904,58768892,1116321554,1085802823,30518731,256140006,829662817,723092447,635855373,87237074,256023333,379832040
Ranthambore,Zoo,Ranthambore-Zoo,BEN_NW17,ZSB_02,494741566,446327947,236382097,48413619,209945850,97142086,1116321554,1085802823,30518731,256140006,829662817,942790346,865053483,77736863,260820720,604232763
Ranthambore,Zoo,Ranthambore-Zoo,BEN_NW17,ZSB_03,470186606,426369192,229456352,43817414,196912840,92177150,1116321554,1085802823,30518731,256140006,829662817,892317758,827799945,64517813,241409256,586390689
Ranthambore,Zoo,Ranthambore-Zoo,BEN_NW17,ZSB_04,423915124,377861565,168229337,46053559,209632228,88273562,1116321554,1085802823,30518731,256140006,829662817,867386629,799476794,67909835,302302125,497174669
Ranthambore,Zoo,Ranthambore-Zoo,BEN_NW17,ZSB_05,412691902,358498262,173733948,54193640,184764314,69193591,1116321554,1085802823,30518731,256140006,829662817,864922054,784467789,80454265,246263826,538203963
Ranthambore,Zoo,Ranthambore-Zoo,BEN_NW18,ZSB_01,436279296,373297857,163538187,62981439,209759670,68860238,1339364699,1300736006,38628693,242877521,1057858485,723092447,635855373,87237074,256023333,379832040
Ranthambore,Zoo,Ranthambore-Zoo,BEN_NW18,ZSB_02,574346620,516122579,292297376,58224041,223825203,124077234,1339364699,1300736006,38628693,242877521,1057858485,942790346,865053483,77736863,260820720,604232763
Ranthambore,Zoo,Ranthambore-Zoo,BEN_NW18,ZSB_03,521442220,468153025,255119414,53289195,213033611,96985763,1339364699,1300736006,38628693,242877521,1057858485,892317758,827799945,64517813,241409256,586390689
Ranthambore,Zoo,Ranthambore-Zoo,BEN_NW18,ZSB_04,519011723,465538007,239616474,53473716,225921533,109725345,1339364699,1300736006,38628693,242877521,1057858485,867386629,799476794,67909835,302302125,497174669
Ranthambore,Zoo,Ranthambore-Zoo,BEN_NW18,ZSB_05,508752567,446734561,246855898,62018006,199878663,96670532,1339364699,1300736006,38628693,242877521,1057858485,864922054,784467789,80454265,246263826,538203963
Ranthambore,Zoo,Ranthambore-Zoo,BEN_NW19,ZSB_01,356382052,300037815,151347433,56344237,148690382,42942270,1081768306,1036331080,45437226,232322355,804008725,723092447,635855373,87237074,256023333,379832040
Ranthambore,Zoo,Ranthambore-Zoo,BEN_NW19,ZSB_02,473740509,417290553,230418160,56449956,186872393,82586033,1081768306,1036331080,45437226,232322355,804008725,942790346,865053483,77736863,260820720,604232763
Ranthambore,Zoo,Ranthambore-Zoo,BEN_NW19,ZSB_03,425749306,375212976,205378522,50536330,169834454,65874521,1081768306,1036331080,45437226,232322355,804008725,892317758,827799945,64517813,241409256,586390689
Ranthambore,Zoo,Ranthambore-Zoo,BEN_NW19,ZSB_04,424735368,376244422,185090289,48490946,191154133,101182693,1081768306,1036331080,45437226,232322355,804008725,867386629,799476794,67909835,302302125,497174669
Ranthambore,Zoo,Ranthambore-Zoo,BEN_NW19,ZSB_05,406112210,351708407,164870900,54403803,186837507,74786800,1081768306,1036331080,45437226,232322355,804008725,864922054,784467789,80454265,246263826,538203963
Ranthambore,Zoo,Ranthambore-Zoo,BEN_NW20,ZSB_01,365416013,298528690,97315101,66887323,201213589,58501027,1086271749,1022278981,63992768,541693814,480585167,723092447,635855373,87237074,256023333,379832040
Ranthambore,Zoo,Ranthambore-Zoo,BEN_NW20,ZSB_02,469646342,404273903,134857723,65372439,269416180,86332551,1086271749,1022278981,63992768,541693814,480585167,942790346,865053483,77736863,260820720,604232763
Ranthambore,Zoo,Ranthambore-Zoo,BEN_NW20,ZSB_03,442484584,383272493,121784016,59212091,261488477,82517237,1086271749,1022278981,63992768,541693814,480585167,892317758,827799945,64517813,241409256,586390689
Ranthambore,Zoo,Ranthambore-Zoo,BEN_NW20,ZSB_04,423643116,364646269,97389565,58996847,267256704,62484942,1086271749,1022278981,63992768,541693814,480585167,867386629,799476794,67909835,302302125,497174669
Ranthambore,Zoo,Ranthambore-Zoo,BEN_NW20,ZSB_05,413071940,343471269,87351937,69600671,256119332,64575761,1086271749,1022278981,63992768,541693814,480585167,864922054,784467789,80454265,246263826,538203963
Ranthambore,Zoo,Ranthambore-Zoo,BEN_NW24,ZSB_01,386924482,324352505,145813748,62571977,178538757,56621506,1159641386,1113494396,46146990,301627698,811866698,723092447,635855373,87237074,256023333,379832040
Ranthambore,Zoo,Ranthambore-Zoo,BEN_NW24,ZSB_02,516154589,457668610,239085841,58485979,218582769,114869220,1159641386,1113494396,46146990,301627698,811866698,942790346,865053483,77736863,260820720,604232763
Ranthambore,Zoo,Ranthambore-Zoo,BEN_NW24,ZSB_03,469774625,416526005,195521486,53248620,221004519,77449703,1159641386,1113494396,46146990,301627698,811866698,892317758,827799945,64517813,241409256,586390689
Ranthambore,Zoo,Ranthambore-Zoo,BEN_NW24,ZSB_04,442767088,389431586,157770655,53335502,231660931,90139741,1159641386,1113494396,46146990,301627698,811866698,867386629,799476794,67909835,302302125,497174669
Ranthambore,Zoo,Ranthambore-Zoo,BEN_NW24,ZSB_05,484541642,427343566,202121881,57198076,225221685,101613015,1159641386,1113494396,46146990,301627698,811866698,864922054,784467789,80454265,246263826,538203963
Ranthambore,Zoo,Ranthambore-Zoo,BEN_NW3,ZSB_01,425390615,366699595,192877457,58691020,173822138,47336267,1280728709,1240123254,40605455,207797688,1032325566,723092447,635855373,87237074,256023333,379832040
Ranthambore,Zoo,Ranthambore-Zoo,BEN_NW3,ZSB_02,535181410,475258285,274310194,59923125,200948091,84414087,1280728709,1240123254,40605455,207797688,1032325566,942790346,865053483,77736863,260820720,604232763
Ranthambore,Zoo,Ranthambore-Zoo,BEN_NW3,ZSB_03,495765933,443588050,264908146,52177883,178679904,83797048,1280728709,1240123254,40605455,207797688,1032325566,892317758,827799945,64517813,241409256,586390689
Ranthambore,Zoo,Ranthambore-Zoo,BEN_NW3,ZSB_04,469907549,414063924,193884474,55843625,220179450,80052794,1280728709,1240123254,40605455,207797688,1032325566,867386629,799476794,67909835,302302125,497174669
Ranthambore,Zoo,Ranthambore-Zoo,BEN_NW3,ZSB_05,498728584,438256361,244162849,60472223,194093512,92235383,1280728709,1240123254,40605455,207797688,1032325566,864922054,784467789,80454265,246263826,538203963
Ranthambore,Zoo,Ranthambore-Zoo,BEN_NW4,ZSB_01,388017565,330558486,164931058,57459079,165627428,38584498,1219365724,1186222475,33143249,158691252,1027531223,723092447,635855373,87237074,256023333,379832040
Ranthambore,Zoo,Ranthambore-Zoo,BEN_NW4,ZSB_02,535968044,484061694,298274599,51906350,185787095,105362138,1219365724,1186222475,33143249,158691252,1027531223,942790346,865053483,77736863,260820720,604232763
Ranthambore,Zoo,Ranthambore-Zoo,BEN_NW4,ZSB_03,484617023,439117883,265178728,45499140,173939155,70889460,1219365724,1186222475,33143249,158691252,1027531223,892317758,827799945,64517813,241409256,586390689
Ranthambore,Zoo,Ranthambore-Zoo,BEN_NW4,ZSB_04,497313167,450903778,248882472,46409389,202021306,110346353,1219365724,1186222475,33143249,158691252,1027531223,867386629,799476794,67909835,302302125,497174669
Ranthambore,Zoo,Ranthambore-Zoo,BEN_NW4,ZSB_05,487698843,433140162,259919916,54558681,173220246,58725995,1219365724,1186222475,33143249,158691252,1027531223,864922054,784467789,80454265,246263826,538203963
Ranthambore,Zoo,Ranthambore-Zoo,BEN_NW5,ZSB_01,326432287,271292635,129638355,55139652,141654280,31570016,977809134,918585062,59224072,241966240,676618822,723092447,635855373,87237074,256023333,379832040
Ranthambore,Zoo,Ranthambore-Zoo,BEN_NW5,ZSB_02,436244183,382621198,209969514,53622985,172651684,56258393,977809134,918585062,59224072,241966240,676618822,942790346,865053483,77736863,260820720,604232763
Ranthambore,Zoo,Ranthambore-Zoo,BEN_NW5,ZSB_03,423790981,375452705,213667932,48338276,161784773,69781186,977809134,918585062,59224072,241966240,676618822,892317758,827799945,64517813,241409256,586390689
Ranthambore,Zoo,Ranthambore-Zoo,BEN_NW5,ZSB_04,411328295,364232973,170348897,47095322,193884076,88150125,977809134,918585062,59224072,241966240,676618822,867386629,799476794,67909835,302302125,497174669
Ranthambore,Zoo,Ranthambore-Zoo,BEN_NW5,ZSB_05,398707420,344197708,165746899,54509712,178450809,58144659,977809134,918585062,59224072,241966240,676618822,864922054,784467789,80454265,246263826,538203963
Ranthambore,Zoo,Ranthambore-Zoo,BEN_NW55,ZSB_01,374635296,311488040,100537624,63147256,210950416,66392550,1131174741,1073214798,57959943,534097691,539117107,723092447,635855373,87237074,256023333,379832040
Ranthambore,Zoo,Ranthambore-Zoo,BEN_NW55,ZSB_02,505262700,440187289,170235347,65075411,269951942,116314156,1131174741,1073214798,57959943,534097691,539117107,942790346,865053483,77736863,260820720,604232763
Ranthambore,Zoo,Ranthambore-Zoo,BEN_NW55,ZSB_03,449875429,390780739,126448776,59094690,264331963,68517901,1131174741,1073214798,57959943,534097691,539117107,892317758,827799945,64517813,241409256,586390689
Ranthambore,Zoo,Ranthambore-Zoo,BEN_NW55,ZSB_04,439101625,380960664,122738721,58140961,258221943,72064687,1131174741,1073214798,57959943,534097691,539117107,867386629,799476794,67909835,302302125,497174669
Ranthambore,Zoo,Ranthambore-Zoo,BEN_NW55,ZSB_05,440273555,374173612,114000273,66099943,260173339,77962550,1131174741,1073214798,57959943,534097691,539117107,864922054,784467789,80454265,246263826,538203963
Ranthambore,Zoo,Ranthambore-Zoo,BEN_NW57,ZSB_01,375002296,300422962,64056860,74579334,236366102,33372679,1180288036,1103120235,77167801,638361097,464759138,723092447,635855373,87237074,256023333,379832040
Ranthambore,Zoo,Ranthambore-Zoo,BEN_NW57,ZSB_02,507127228,430031883,131362313,77095345,298669570,95385298,1180288036,1103120235,77167801,638361097,464759138,942790346,865053483,77736863,260820720,604232763
Ranthambore,Zoo,Ranthambore-Zoo,BEN_NW57,ZSB_03,434417342,362895636,84639193,71521706,278256443,57130454,1180288036,1103120235,77167801,638361097,464759138,892317758,827799945,64517813,241409256,586390689
Ranthambore,Zoo,Ranthambore-Zoo,BEN_NW57,ZSB_04,462355284,393064878,95831172,69290406,297233706,77459716,1180288036,1103120235,77167801,638361097,464759138,867386629,799476794,67909835,302302125,497174669
Ranthambore,Zoo,Ranthambore-Zoo,BEN_NW57,ZSB_05,415199053,337268308,62427884,77930745,274840424,44914524,1180288036,1103120235,77167801,638361097,464759138,864922054,784467789,80454265,246263826,538203963
Ranthambore,Zoo,Ranthambore-Zoo,BEN_NW6,ZSB_01,319368860,265656463,108677228,53712397,156979235,43485953,992143483,946435718,45707765,248527765,697907953,723092447,635855373,87237074,256023333,379832040
Ranthambore,Zoo,Ranthambore-Zoo,BEN_NW6,ZSB_02,434442644,380073216,184770611,54369428,195302605,81775974,992143483,946435718,45707765,248527765,697907953,942790346,865053483,77736863,260820720,604232763
Ranthambore,Zoo,Ranthambore-Zoo,BEN_NW6,ZSB_03,399310757,352577557,180472162,46733200,172105395,82903421,992143483,946435718,45707765,248527765,697907953,892317758,827799945,64517813,241409256,586390689
Ranthambore,Zoo,Ranthambore-Zoo,BEN_NW6,ZSB_04,360029555,311727959,130993162,48301596,180734797,72045967,992143483,946435718,45707765,248527765,697907953,867386629,799476794,67909835,302302125,497174669
Ranthambore,Zoo,Ranthambore-Zoo,BEN_NW6,ZSB_05,358106206,305137944,120717836,52968262,184420108,70697762,992143483,946435718,45707765,248527765,697907953,864922054,784467789,80454265,246263826,538203963
Ranthambore,Zoo,Ranthambore-Zoo,BEN_NW8,ZSB_01,357137982,295566885,111975740,61571097,183591145,50775381,1196839698,1156984240,39855458,275076038,881908202,723092447,635855373,87237074,256023333,379832040
Ranthambore,Zoo,Ranthambore-Zoo,BEN_NW8,ZSB_02,504575061,445528176,230098626,59046885,215429550,105648431,1196839698,1156984240,39855458,275076038,881908202,942790346,865053483,77736863,260820720,604232763
Ranthambore,Zoo,Ranthambore-Zoo,BEN_NW8,ZSB_03,447636215,394392803,176729836,53243412,217662967,90424733,1196839698,1156984240,39855458,275076038,881908202,892317758,827799945,64517813,241409256,586390689
Ranthambore,Zoo,Ranthambore-Zoo,BEN_NW8,ZSB_04,515766608,466496146,237831549,49270462,228664597,127497484,1196839698,1156984240,39855458,275076038,881908202,867386629,799476794,67909835,302302125,497174669
Ranthambore,Zoo,Ranthambore-Zoo,BEN_NW8,ZSB_05,458803793,399979796,192890269,58823997,207089527,88680197,1196839698,1156984240,39855458,275076038,881908202,864922054,784467789,80454265,246263826,538203963
Ranthambore,Zoo,Ranthambore-Zoo,BEN_NW9,ZSB_01,411178072,349998917,171277766,61179155,178721151,59097541,1246521228,1203200533,43320695,216389572,986810961,723092447,635855373,87237074,256023333,379832040
Ranthambore,Zoo,Ranthambore-Zoo,BEN_NW9,ZSB_02,542775146,483293600,270106488,59481546,213187112,97032995,1246521228,1203200533,43320695,216389572,986810961,942790346,865053483,77736863,260820720,604232763
Ranthambore,Zoo,Ranthambore-Zoo,BEN_NW9,ZSB_03,497464703,444961431,246470014,52503272,198491417,81504010,1246521228,1203200533,43320695,216389572,986810961,892317758,827799945,64517813,241409256,586390689
Ranthambore,Zoo,Ranthambore-Zoo,BEN_NW9,ZSB_04,491064535,439868179,217402388,51196356,222465791,88189872,1246521228,1203200533,43320695,216389572,986810961,867386629,799476794,67909835,302302125,497174669
Ranthambore,Zoo,Ranthambore-Zoo,BEN_NW9,ZSB_05,472387240,411662781,208079761,60724459,203583020,64529242,1246521228,1203200533,43320695,216389572,986810961,864922054,784467789,80454265,246263826,538203963
Wayanad,Chandrapur,Wayanad-Chandrapur,BEN_SI1,BEN_CI2,271141176,234827073,79769069,36314103,155058004,23373227,897358653,799698739,97659914,345341326,454357413,674364895,657438378,16926517,229909737,427528641
Wayanad,Chandrapur,Wayanad-Chandrapur,BEN_SI11,BEN_CI2,213338690,199668036,92981245,13670654,106686791,33607837,641166204,612648765,28517439,241001807,371646958,674364895,657438378,16926517,229909737,427528641
Wayanad,Chandrapur,Wayanad-Chandrapur,BEN_SI2,BEN_CI2,186529224,178491171,68371991,8038053,110119180,19498496,650993225,648515374,2477851,140667619,507847755,674364895,657438378,16926517,229909737,427528641
Wayanad,Chandrapur,Wayanad-Chandrapur,BEN_SI3,BEN_CI2,319881927,288630700,133849484,31251227,154781216,72114371,931565359,847325564,84239795,345974583,501350981,674364895,657438378,16926517,229909737,427528641
Wayanad,Chandrapur,Wayanad-Chandrapur,BEN_SI4,BEN_CI2,372757538,342800282,189151556,29957256,153648726,52822709,1109312253,1030580255,78731998,302255092,728325163,674364895,657438378,16926517,229909737,427528641
Wayanad,Chandrapur,Wayanad-Chandrapur,BEN_SI6,BEN_CI2,275656795,243757318,85849435,31899477,157907883,57087140,951080464,864453508,86626956,319674486,544779022,674364895,657438378,16926517,229909737,427528641
Wayanad,Chandrapur,Wayanad-Chandrapur,BEN_SI7,BEN_CI2,321450525,288923400,139148645,32527125,149774755,62273467,942430262,853584663,88845599,335397181,518187482,674364895,657438378,16926517,229909737,427528641
Wayanad,Chandrapur,Wayanad-Chandrapur,BEN_SI8,BEN_CI2,372688990,341439915,190884018,31249075,150555897,49889514,1108177315,1029030472,79146843,300308119,728722353,674364895,657438378,16926517,229909737,427528641
Wayanad,Chandrapur,Wayanad-Chandrapur,BEN_SI9,BEN_CI2,241028206,204641403,53998907,36386803,150642496,26831725,849233213,745820153,103413060,339499389,406320764,674364895,657438378,16926517,229909737,427528641
Wayanad,Corbett,Wayanad-Corbett,BEN_SI1,BEN_NOR1,280816684,209661691,34254520,71154993,175407171,24625993,897358653,799698739,97659914,345341326,454357413,689133358,592060124,97073234,396388890,195671234
Wayanad,Corbett,Wayanad-Corbett,BEN_SI1,BEN_NOR2,362302244,284628891,101884248,77673353,182744643,48040106,897358653,799698739,97659914,345341326,454357413,872604239,770086648,102517591,315997124,454089524
Wayanad,Corbett,Wayanad-Corbett,BEN_SI11,BEN_NOR1,218752137,178644101,32015455,40108036,146628646,27777753,641166204,612648765,28517439,241001807,371646958,689133358,592060124,97073234,396388890,195671234
Wayanad,Corbett,Wayanad-Corbett,BEN_SI11,BEN_NOR2,240099614,197020145,68944005,43079469,128076140,36722509,641166204,612648765,28517439,241001807,371646958,872604239,770086648,102517591,315997124,454089524
Wayanad,Corbett,Wayanad-Corbett,BEN_SI2,BEN_NOR1,201259362,169971769,41008872,31287593,128962897,28106419,650993225,648515374,2477851,140667619,507847755,689133358,592060124,97073234,396388890,195671234
Wayanad,Corbett,Wayanad-Corbett,BEN_SI2,BEN_NOR2,247971062,216566419,86928923,31404643,129637496,54055376,650993225,648515374,2477851,140667619,507847755,872604239,770086648,102517591,315997124,454089524
Wayanad,Corbett,Wayanad-Corbett,BEN_SI3,BEN_NOR1,279421651,208792871,27142768,70628780,181650103,19037707,931565359,847325564,84239795,345974583,501350981,689133358,592060124,97073234,396388890,195671234
Wayanad,Corbett,Wayanad-Corbett,BEN_SI3,BEN_NOR2,356939718,282027623,97720875,74912095,184306748,55518997,931565359,847325564,84239795,345974583,501350981,872604239,770086648,102517591,315997124,454089524
Wayanad,Corbett,Wayanad-Corbett,BEN_SI4,BEN_NOR1,340300854,267530014,65929488,72770840,201600526,56118526,1109312253,1030580255,78731998,302255092,728325163,689133358,592060124,97073234,396388890,195671234
Wayanad,Corbett,Wayanad-Corbett,BEN_SI4,BEN_NOR2,428303161,349252367,127029976,79050794,222222391,47812420,1109312253,1030580255,78731998,302255092,728325163,872604239,770086648,102517591,315997124,454089524
Wayanad,Corbett,Wayanad-Corbett,BEN_SI6,BEN_NOR1,285198788,216207478,33531903,68991310,182675575,25484251,951080464,864453508,86626956,319674486,544779022,689133358,592060124,97073234,396388890,195671234
Wayanad,Corbett,Wayanad-Corbett,BEN_SI6,BEN_NOR2,386988103,313304904,135136480,73683199,178168424,58644519,951080464,864453508,86626956,319674486,544779022,872604239,770086648,102517591,315997124,454089524
Wayanad,Corbett,Wayanad-Corbett,BEN_SI7,BEN_NOR1,283377514,211126988,29890870,72250526,181236118,17582846,942430262,853584663,88845599,335397181,518187482,689133358,592060124,97073234,396388890,195671234
Wayanad,Corbett,Wayanad-Corbett,BEN_SI7,BEN_NOR2,361672999,284316204,98494139,77356795,185822065,51645219,942430262,853584663,88845599,335397181,518187482,872604239,770086648,102517591,315997124,454089524
Wayanad,Corbett,Wayanad-Corbett,BEN_SI8,BEN_NOR1,339028258,265685868,64027203,73342390,201658665,49303244,1108177315,1029030472,79146843,300308119,728722353,689133358,592060124,97073234,396388890,195671234
Wayanad,Corbett,Wayanad-Corbett,BEN_SI8,BEN_NOR2,427370233,347718268,130475646,79651965,217242622,50976035,1108177315,1029030472,79146843,300308119,728722353,872604239,770086648,102517591,315997124,454089524
Wayanad,Corbett,Wayanad-Corbett,BEN_SI9,BEN_NOR1,258656593,189154215,36943145,69502378,152211070,31653345,849233213,745820153,103413060,339499389,406320764,689133358,592060124,97073234,396388890,195671234
Wayanad,Corbett,Wayanad-Corbett,BEN_SI9,BEN_NOR2,346113453,270329680,86561486,75783773,183768194,45678554,849233213,745820153,103413060,339499389,406320764,872604239,770086648,102517591,315997124,454089524
Wayanad,Kanha,Wayanad-Kanha,BEN_SI1,BEN_CI15,223180896,152089871,17818430,71091025,134271441,13510772,897358653,799698739,97659914,345341326,454357413,558426844,440368350,118058494,313676252,126692098
Wayanad,Kanha,Wayanad-Kanha,BEN_SI1,BEN_CI16,400800096,332427521,144034030,68372575,188393491,56983388,897358653,799698739,97659914,345341326,454357413,941465693,865515372,75950321,260165870,605349502
Wayanad,Kanha,Wayanad-Kanha,BEN_SI1,BEN_CI18,216376235,145787251,27890080,70588984,117897171,18741165,897358653,799698739,97659914,345341326,454357413,531335982,416398696,114937286,280261230,136137466
Wayanad,Kanha,Wayanad-Kanha,BEN_SI1,BEN_CI19,139615729,78323630,,61292099,78323630,,897358653,799698739,97659914,345341326,454357413,370653731,261143653,109510078,241812071,19331582
Wayanad,Kanha,Wayanad-Kanha,BEN_SI1,BEN_CI3,238923488,168651617,31408675,70271871,137242942,5798264,897358653,799698739,97659914,345341326,454357413,399948004,398407865,1540139,114426239,283981626
Wayanad,Kanha,Wayanad-Kanha,BEN_SI1,BEN_CI4,247107781,189583789,58504416,57523992,131079373,24519569,897358653,799698739,97659914,345341326,454357413,588039664,506748544,81291120,270707157,236041387
Wayanad,Kanha,Wayanad-Kanha,BEN_SI1,BEN_CI5,177699801,122972327,8416831,54727474,114555496,3604980,897358653,799698739,97659914,345341326,454357413,447217937,358814659,88403278,289122614,69692045
Wayanad,Kanha,Wayanad-Kanha,BEN_SI1,BEN_CI6,221067784,156363019,24179983,64704765,132183036,15687248,897358653,799698739,97659914,345341326,454357413,558093435,456569955,101523480,304633087,151936868
Wayanad,Kanha,Wayanad-Kanha,BEN_SI1,BEN_CI7,326169649,290787484,146193072,35382165,144594412,34043852,897358653,799698739,97659914,345341326,454357413,746271387,730520258,15751129,197580294,532939964
Wayanad,Kanha,Wayanad-Kanha,BEN_SI11,BEN_CI15,163014081,123056650,24749912,39957431,98306738,18480976,641166204,612648765,28517439,241001807,371646958,558426844,440368350,118058494,313676252,126692098
Wayanad,Kanha,Wayanad-Kanha,BEN_SI11,BEN_CI16,256842149,222796753,71791885,34045396,151004868,27559531,641166204,612648765,28517439,241001807,371646958,941465693,865515372,75950321,260165870,605349502
Wayanad,Kanha,Wayanad-Kanha,BEN_SI11,BEN_CI18,137211940,94635983,5963478,42575957,88672505,5963478,641166204,612648765,28517439,241001807,371646958,531335982,416398696,114937286,280261230,136137466
Wayanad,Kanha,Wayanad-Kanha,BEN_SI11,BEN_CI19,100705757,63173818,2232276,37531939,60941542,2232276,641166204,612648765,28517439,241001807,371646958,370653731,261143653,109510078,241812071,19331582
Wayanad,Kanha,Wayanad-Kanha,BEN_SI11,BEN_CI3,168756234,128977723,25532141,39778511,103445582,16876271,641166204,612648765,28517439,241001807,371646958,399948004,398407865,1540139,114426239,283981626
Wayanad,Kanha,Wayanad-Kanha,BEN_SI11,BEN_CI4,169063725,136634902,30969430,32428823,105665472,16011621,641166204,612648765,28517439,241001807,371646958,588039664,506748544,81291120,270707157,236041387
Wayanad,Kanha,Wayanad-Kanha,BEN_SI11,BEN_CI5,126757445,94372912,7615139,32384533,86757773,5261878,641166204,612648765,28517439,241001807,371646958,447217937,358814659,88403278,289122614,69692045
Wayanad,Kanha,Wayanad-Kanha,BEN_SI11,BEN_CI6,164597573,127283901,30444032,37313672,96839869,19088954,641166204,612648765,28517439,241001807,371646958,558093435,456569955,101523480,304633087,151936868
Wayanad,Kanha,Wayanad-Kanha,BEN_SI11,BEN_CI7,226829036,215727479,98937670,11101557,116789809,36722959,641166204,612648765,28517439,241001807,371646958,746271387,730520258,15751129,197580294,532939964
Wayanad,Kanha,Wayanad-Kanha,BEN_SI2,BEN_CI15,160430091,124803346,22510924,35626745,102292422,10082853,650993225,648515374,2477851,140667619,507847755,558426844,440368350,118058494,313676252,126692098
Wayanad,Kanha,Wayanad-Kanha,BEN_SI2,BEN_CI16,275068117,253016037,128619954,22052080,124396083,48251082,650993225,648515374,2477851,140667619,507847755,941465693,865515372,75950321,260165870,605349502
Wayanad,Kanha,Wayanad-Kanha,BEN_SI2,BEN_CI18,166660519,131545584,36572939,35114935,94972645,18613415,650993225,648515374,2477851,140667619,507847755,531335982,416398696,114937286,280261230,136137466
Wayanad,Kanha,Wayanad-Kanha,BEN_SI2,BEN_CI19,110745063,78670373,2758467,32074690,75911906,2758467,650993225,648515374,2477851,140667619,507847755,370653731,261143653,109510078,241812071,19331582
Wayanad,Kanha,Wayanad-Kanha,BEN_SI2,BEN_CI3,196532930,159789755,59628142,36743175,100161613,23366857,650993225,648515374,2477851,140667619,507847755,399948004,398407865,1540139,114426239,283981626
Wayanad,Kanha,Wayanad-Kanha,BEN_SI2,BEN_CI4,180026124,156138886,72898873,23887238,83240013,16881626,650993225,648515374,2477851,140667619,507847755,588039664,506748544,81291120,270707157,236041387
Wayanad,Kanha,Wayanad-Kanha,BEN_SI2,BEN_CI5,121618850,93246139,11986664,28372711,81259475,9109733,650993225,648515374,2477851,140667619,507847755,447217937,358814659,88403278,289122614,69692045
Wayanad,Kanha,Wayanad-Kanha,BEN_SI2,BEN_CI6,152992375,122248174,20625398,30744201,101622776,13040538,650993225,648515374,2477851,140667619,507847755,558093435,456569955,101523480,304633087,151936868
Wayanad,Kanha,Wayanad-Kanha,BEN_SI2,BEN_CI7,218088567,211069959,114568570,7018608,96501389,21027753,650993225,648515374,2477851,140667619,507847755,746271387,730520258,15751129,197580294,532939964
Wayanad,Kanha,Wayanad-Kanha,BEN_SI3,BEN_CI15,230465593,161602967,12354386,68862626,149248581,12354386,931565359,847325564,84239795,345974583,501350981,558426844,440368350,118058494,313676252,126692098
Wayanad,Kanha,Wayanad-Kanha,BEN_SI3,BEN_CI16,401412354,334063055,136423264,67349299,197639791,59057584,931565359,847325564,84239795,345974583,501350981,941465693,865515372,75950321,260165870,605349502
Wayanad,Kanha,Wayanad-Kanha,BEN_SI3,BEN_CI18,221409177,153140082,18906833,68269095,134233249,18906833,931565359,847325564,84239795,345974583,501350981,531335982,416398696,114937286,280261230,136137466
Wayanad,Kanha,Wayanad-Kanha,BEN_SI3,BEN_CI19,163086176,101186708,2948374,61899468,98238334,2948374,931565359,847325564,84239795,345974583,501350981,370653731,261143653,109510078,241812071,19331582
Wayanad,Kanha,Wayanad-Kanha,BEN_SI3,BEN_CI3,250324995,181800021,37352126,68524974,144447895,19366331,931565359,847325564,84239795,345974583,501350981,399948004,398407865,1540139,114426239,283981626
Wayanad,Kanha,Wayanad-Kanha,BEN_SI3,BEN_CI4,240906056,184863546,38940697,56042510,145922849,24121940,931565359,847325564,84239795,345974583,501350981,588039664,506748544,81291120,270707157,236041387
Wayanad,Kanha,Wayanad-Kanha,BEN_SI3,BEN_CI5,187917576,133405252,12186568,54512324,121218684,10138184,931565359,847325564,84239795,345974583,501350981,447217937,358814659,88403278,289122614,69692045
Wayanad,Kanha,Wayanad-Kanha,BEN_SI3,BEN_CI6,232706925,169883452,40402992,62823473,129480460,15597901,931565359,847325564,84239795,345974583,501350981,558093435,456569955,101523480,304633087,151936868
Wayanad,Kanha,Wayanad-Kanha,BEN_SI3,BEN_CI7,303739053,268732633,111393160,35006420,157339473,43784545,931565359,847325564,84239795,345974583,501350981,746271387,730520258,15751129,197580294,532939964
Wayanad,Kanha,Wayanad-Kanha,BEN_SI4,BEN_CI15,289345512,213223654,54832925,76121858,158390729,27875185,1109312253,1030580255,78731998,302255092,728325163,558426844,440368350,118058494,313676252,126692098
Wayanad,Kanha,Wayanad-Kanha,BEN_SI4,BEN_CI16,457147801,388549272,193816710,68598529,194732562,63062029,1109312253,1030580255,78731998,302255092,728325163,941465693,865515372,75950321,260165870,605349502
Wayanad,Kanha,Wayanad-Kanha,BEN_SI4,BEN_CI18,246563109,172280392,25735273,74282717,146545119,18598295,1109312253,1030580255,78731998,302255092,728325163,531335982,416398696,114937286,280261230,136137466
Wayanad,Kanha,Wayanad-Kanha,BEN_SI4,BEN_CI19,199376115,131690383,7303337,67685732,124387046,7303337,1109312253,1030580255,78731998,302255092,728325163,370653731,261143653,109510078,241812071,19331582
Wayanad,Kanha,Wayanad-Kanha,BEN_SI4,BEN_CI3,300969558,224493383,54841085,76476175,169652298,24882968,1109312253,1030580255,78731998,302255092,728325163,399948004,398407865,1540139,114426239,283981626
Wayanad,Kanha,Wayanad-Kanha,BEN_SI4,BEN_CI4,277984398,217119617,59147634,60864781,157971983,45234617,1109312253,1030580255,78731998,302255092,728325163,588039664,506748544,81291120,270707157,236041387
Wayanad,Kanha,Wayanad-Kanha,BEN_SI4,BEN_CI5,226554142,169918315,27774820,56635827,142143495,13066234,1109312253,1030580255,78731998,302255092,728325163,447217937,358814659,88403278,289122614,69692045
Wayanad,Kanha,Wayanad-Kanha,BEN_SI4,BEN_CI6,281325551,214458693,50977659,66866858,163481034,20621281,1109312253,1030580255,78731998,302255092,728325163,558093435,456569955,101523480,304633087,151936868
Wayanad,Kanha,Wayanad-Kanha,BEN_SI4,BEN_CI7,393392766,363472163,198275980,29920603,165196183,53823755,1109312253,1030580255,78731998,302255092,728325163,746271387,730520258,15751129,197580294,532939964
Wayanad,Kanha,Wayanad-Kanha,BEN_SI6,BEN_CI15,235055732,165602648,15349816,69453084,150252832,15349816,951080464,864453508,86626956,319674486,544779022,558426844,440368350,118058494,313676252,126692098
Wayanad,Kanha,Wayanad-Kanha,BEN_SI6,BEN_CI16,414423483,347828979,154838336,66594504,192990643,66637609,951080464,864453508,86626956,319674486,544779022,941465693,865515372,75950321,260165870,605349502
Wayanad,Kanha,Wayanad-Kanha,BEN_SI6,BEN_CI18,225003075,155428251,16880226,69574824,138548025,14145826,951080464,864453508,86626956,319674486,544779022,531335982,416398696,114937286,280261230,136137466
Wayanad,Kanha,Wayanad-Kanha,BEN_SI6,BEN_CI19,162637185,99538883,2226310,63098302,97312573,2226310,951080464,864453508,86626956,319674486,544779022,370653731,261143653,109510078,241812071,19331582
Wayanad,Kanha,Wayanad-Kanha,BEN_SI6,BEN_CI3,271253629,199816629,53770038,71437000,146046591,21707098,951080464,864453508,86626956,319674486,544779022,399948004,398407865,1540139,114426239,283981626
Wayanad,Kanha,Wayanad-Kanha,BEN_SI6,BEN_CI4,262701734,207127990,65535773,55573744,141592217,31461918,951080464,864453508,86626956,319674486,544779022,588039664,506748544,81291120,270707157,236041387
Wayanad,Kanha,Wayanad-Kanha,BEN_SI6,BEN_CI5,196447769,145148347,14434924,51299422,130713423,5986073,951080464,864453508,86626956,319674486,544779022,447217937,358814659,88403278,289122614,69692045
Wayanad,Kanha,Wayanad-Kanha,BEN_SI6,BEN_CI6,244911055,182664390,48150494,62246665,134513896,32041958,951080464,864453508,86626956,319674486,544779022,558093435,456569955,101523480,304633087,151936868
Wayanad,Kanha,Wayanad-Kanha,BEN_SI6,BEN_CI7,300358113,264711068,100913556,35647045,163797512,38351797,951080464,864453508,86626956,319674486,544779022,746271387,730520258,15751129,197580294,532939964
Wayanad,Kanha,Wayanad-Kanha,BEN_SI7,BEN_CI15,233134014,162279942,15218020,70854072,147061922,12449020,942430262,853584663,88845599,335397181,518187482,558426844,440368350,118058494,313676252,126692098
Wayanad,Kanha,Wayanad-Kanha,BEN_SI7,BEN_CI16,405316803,334686166,139955444,70630637,194730722,53157653,942430262,853584663,88845599,335397181,518187482,941465693,865515372,75950321,260165870,605349502
Wayanad,Kanha,Wayanad-Kanha,BEN_SI7,BEN_CI18,223195981,153339922,21866970,69856059,131472952,21866970,942430262,853584663,88845599,335397181,518187482,531335982,416398696,114937286,280261230,136137466
Wayanad,Kanha,Wayanad-Kanha,BEN_SI7,BEN_CI19,163943445,100505288,2948374,63438157,97556914,2948374,942430262,853584663,88845599,335397181,518187482,370653731,261143653,109510078,241812071,19331582
Wayanad,Kanha,Wayanad-Kanha,BEN_SI7,BEN_CI3,255412195,183994803,38493754,71417392,145501049,16434007,942430262,853584663,88845599,335397181,518187482,399948004,398407865,1540139,114426239,283981626
Wayanad,Kanha,Wayanad-Kanha,BEN_SI7,BEN_CI4,242854451,185653162,47765236,57201289,137887926,27699201,942430262,853584663,88845599,335397181,518187482,588039664,506748544,81291120,270707157,236041387
Wayanad,Kanha,Wayanad-Kanha,BEN_SI7,BEN_CI5,190423030,133721415,12377934,56701615,121343481,10329550,942430262,853584663,88845599,335397181,518187482,447217937,358814659,88403278,289122614,69692045
Wayanad,Kanha,Wayanad-Kanha,BEN_SI7,BEN_CI6,234862128,169208557,39580994,65653571,129627563,11419660,942430262,853584663,88845599,335397181,518187482,558093435,456569955,101523480,304633087,151936868
Wayanad,Kanha,Wayanad-Kanha,BEN_SI7,BEN_CI7,306870544,270444529,110896818,36426015,159547711,41971591,942430262,853584663,88845599,335397181,518187482,746271387,730520258,15751129,197580294,532939964
Wayanad,Kanha,Wayanad-Kanha,BEN_SI8,BEN_CI15,288328753,211057548,55744609,77271205,155312939,30778852,1108177315,1029030472,79146843,300308119,728722353,558426844,440368350,118058494,313676252,126692098
Wayanad,Kanha,Wayanad-Kanha,BEN_SI8,BEN_CI16,457109470,388537405,187705954,68572065,200831451,55682467,1108177315,1029030472,79146843,300308119,728722353,941465693,865515372,75950321,260165870,605349502
Wayanad,Kanha,Wayanad-Kanha,BEN_SI8,BEN_CI18,246874159,173246957,24206103,73627202,149040854,15961146,1108177315,1029030472,79146843,300308119,728722353,531335982,416398696,114937286,280261230,136137466
Wayanad,Kanha,Wayanad-Kanha,BEN_SI8,BEN_CI19,198538300,131189764,6153911,67348536,125035853,6153911,1108177315,1029030472,79146843,300308119,728722353,370653731,261143653,109510078,241812071,19331582
Wayanad,Kanha,Wayanad-Kanha,BEN_SI8,BEN_CI3,300235209,224000527,57181880,76234682,166818647,21213372,1108177315,1029030472,79146843,300308119,728722353,399948004,398407865,1540139,114426239,283981626
Wayanad,Kanha,Wayanad-Kanha,BEN_SI8,BEN_CI4,277982507,216625658,55837387,61356849,160788271,37790616,1108177315,1029030472,79146843,300308119,728722353,588039664,506748544,81291120,270707157,236041387
Wayanad,Kanha,Wayanad-Kanha,BEN_SI8,BEN_CI5,227008694,170655272,24778900,56353422,145876372,12133829,1108177315,1029030472,79146843,300308119,728722353,447217937,358814659,88403278,289122614,69692045
Wayanad,Kanha,Wayanad-Kanha,BEN_SI8,BEN_CI6,281155728,213927651,52538494,67228077,161389157,24112619,1108177315,1029030472,79146843,300308119,728722353,558093435,456569955,101523480,304633087,151936868
Wayanad,Kanha,Wayanad-Kanha,BEN_SI8,BEN_CI7,393237846,363841811,203908294,29396035,159933517,45939329,1108177315,1029030472,79146843,300308119,728722353,746271387,730520258,15751129,197580294,532939964
Wayanad,Kanha,Wayanad-Kanha,BEN_SI9,BEN_CI15,214972274,148570595,22310885,66401679,126259710,16028747,849233213,745820153,103413060,339499389,406320764,558426844,440368350,118058494,313676252,126692098
Wayanad,Kanha,Wayanad-Kanha,BEN_SI9,BEN_CI16,355230296,288542216,110680320,66688080,177861896,44786989,849233213,745820153,103413060,339499389,406320764,941465693,865515372,75950321,260165870,605349502
Wayanad,Kanha,Wayanad-Kanha,BEN_SI9,BEN_CI18,210631149,144502831,26984087,66128318,117518744,21763476,849233213,745820153,103413060,339499389,406320764,531335982,416398696,114937286,280261230,136137466
Wayanad,Kanha,Wayanad-Kanha,BEN_SI9,BEN_CI19,137039459,77497717,2209055,59541742,75288662,2209055,849233213,745820153,103413060,339499389,406320764,370653731,261143653,109510078,241812071,19331582
Wayanad,Kanha,Wayanad-Kanha,BEN_SI9,BEN_CI3,219926856,151011545,17346645,68915311,133664900,10228989,849233213,745820153,103413060,339499389,406320764,399948004,398407865,1540139,114426239,283981626
Wayanad,Kanha,Wayanad-Kanha,BEN_SI9,BEN_CI4,223353444,169602435,34453640,53751009,135148795,20157526,849233213,745820153,103413060,339499389,406320764,588039664,506748544,81291120,270707157,236041387
Wayanad,Kanha,Wayanad-Kanha,BEN_SI9,BEN_CI5,167391101,113103826,9559922,54287275,103543904,7511538,849233213,745820153,103413060,339499389,406320764,447217937,358814659,88403278,289122614,69692045
Wayanad,Kanha,Wayanad-Kanha,BEN_SI9,BEN_CI6,226108763,168445734,41542272,57663029,126903462,20019766,849233213,745820153,103413060,339499389,406320764,558093435,456569955,101523480,304633087,151936868
Wayanad,Kanha,Wayanad-Kanha,BEN_SI9,BEN_CI7,277249075,238964001,95185548,38285074,143778453,36336388,849233213,745820153,103413060,339499389,406320764,746271387,730520258,15751129,197580294,532939964
Wayanad,Kaziranga,Wayanad-Kaziranga,BEN_SI1,BEN_NE1,222973773,145381126,13968118,77592647,131413008,9265503,897358653,799698739,97659914,345341326,454357413,560246780,423100976,137145804,256700947,166400029
Wayanad,Kaziranga,Wayanad-Kaziranga,BEN_SI1,BEN_NE2,481104062,394948761,165264882,86155301,229683879,57352864,897358653,799698739,97659914,345341326,454357413,1250511108,1174630426,75880682,233913209,940717217
Wayanad,Kaziranga,Wayanad-Kaziranga,BEN_SI1,BEN_NE3,418339140,343951307,149775094,74387833,194176213,60462920,897358653,799698739,97659914,345341326,454357413,1008859852,937520336,71339516,277485474,660034862
Wayanad,Kaziranga,Wayanad-Kaziranga,BEN_SI11,BEN_NE1,145287576,99362472,9202203,45925104,90160269,6651825,641166204,612648765,28517439,241001807,371646958,560246780,423100976,137145804,256700947,166400029
Wayanad,Kaziranga,Wayanad-Kaziranga,BEN_SI11,BEN_NE2,382119563,345144246,170873601,36975317,174270645,81084539,641166204,612648765,28517439,241001807,371646958,1250511108,1174630426,75880682,233913209,940717217
Wayanad,Kaziranga,Wayanad-Kaziranga,BEN_SI11,BEN_NE3,264205890,226432447,72890303,37773443,153542144,47842894,641166204,612648765,28517439,241001807,371646958,1008859852,937520336,71339516,277485474,660034862
Wayanad,Kaziranga,Wayanad-Kaziranga,BEN_SI2,BEN_NE1,153951848,112494096,21418629,41457752,91075467,14219868,650993225,648515374,2477851,140667619,507847755,560246780,423100976,137145804,256700947,166400029
Wayanad,Kaziranga,Wayanad-Kaziranga,BEN_SI2,BEN_NE2,352832932,327979779,204631204,24853153,123348575,54812076,650993225,648515374,2477851,140667619,507847755,1250511108,1174630426,75880682,233913209,940717217
Wayanad,Kaziranga,Wayanad-Kaziranga,BEN_SI2,BEN_NE3,296866822,273426938,144528280,23439884,128898658,61343066,650993225,648515374,2477851,140667619,507847755,1008859852,937520336,71339516,277485474,660034862
Wayanad,Kaziranga,Wayanad-Kaziranga,BEN_SI3,BEN_NE1,213120166,135957881,16274492,77162285,119683389,14169066,931565359,847325564,84239795,345974583,501350981,560246780,423100976,137145804,256700947,166400029
Wayanad,Kaziranga,Wayanad-Kaziranga,BEN_SI3,BEN_NE2,545079927,468596044,248194584,76483883,220401460,84793702,931565359,847325564,84239795,345974583,501350981,1250511108,1174630426,75880682,233913209,940717217
Wayanad,Kaziranga,Wayanad-Kaziranga,BEN_SI3,BEN_NE3,432443089,364570912,165832716,67872177,198738196,75021596,931565359,847325564,84239795,345974583,501350981,1008859852,937520336,71339516,277485474,660034862
Wayanad,Kaziranga,Wayanad-Kaziranga,BEN_SI4,BEN_NE1,282017259,199958164,62813553,82059095,137144611,27744502,1109312253,1030580255,78731998,302255092,728325163,560246780,423100976,137145804,256700947,166400029
Wayanad,Kaziranga,Wayanad-Kaziranga,BEN_SI4,BEN_NE2,634940889,555173202,325352171,79767687,229821031,87715177,1109312253,1030580255,78731998,302255092,728325163,1250511108,1174630426,75880682,233913209,940717217
Wayanad,Kaziranga,Wayanad-Kaziranga,BEN_SI4,BEN_NE3,485484846,412429892,195785044,73054954,216644848,65299940,1109312253,1030580255,78731998,302255092,728325163,1008859852,937520336,71339516,277485474,660034862
Wayanad,Kaziranga,Wayanad-Kaziranga,BEN_SI6,BEN_NE1,229846758,150810824,18781444,79035934,132029380,10806672,951080464,864453508,86626956,319674486,544779022,560246780,423100976,137145804,256700947,166400029
Wayanad,Kaziranga,Wayanad-Kaziranga,BEN_SI6,BEN_NE2,539600917,459772466,246296911,79828451,213475555,87852627,951080464,864453508,86626956,319674486,544779022,1250511108,1174630426,75880682,233913209,940717217
Wayanad,Kaziranga,Wayanad-Kaziranga,BEN_SI6,BEN_NE3,409079947,332917074,115861590,76162873,217055484,64035428,951080464,864453508,86626956,319674486,544779022,1008859852,937520336,71339516,277485474,660034862
Wayanad,Kaziranga,Wayanad-Kaziranga,BEN_SI7,BEN_NE1,215206145,136443937,19421778,78762208,117022159,15218702,942430262,853584663,88845599,335397181,518187482,560246780,423100976,137145804,256700947,166400029
Wayanad,Kaziranga,Wayanad-Kaziranga,BEN_SI7,BEN_NE2,551643555,472966714,260931216,78676841,212035498,70781149,942430262,853584663,88845599,335397181,518187482,1250511108,1174630426,75880682,233913209,940717217
Wayanad,Kaziranga,Wayanad-Kaziranga,BEN_SI7,BEN_NE3,437185719,365071186,167201165,72114533,197870021,82652422,942430262,853584663,88845599,335397181,518187482,1008859852,937520336,71339516,277485474,660034862
Wayanad,Kaziranga,Wayanad-Kaziranga,BEN_SI8,BEN_NE1,280869981,198925137,62982231,81944844,135942906,23127840,1108177315,1029030472,79146843,300308119,728722353,560246780,423100976,137145804,256700947,166400029
Wayanad,Kaziranga,Wayanad-Kaziranga,BEN_SI8,BEN_NE2,634720459,554425770,325966867,80294689,228458903,79746264,1108177315,1029030472,79146843,300308119,728722353,1250511108,1174630426,75880682,233913209,940717217
Wayanad,Kaziranga,Wayanad-Kaziranga,BEN_SI8,BEN_NE3,486348741,412136620,198584084,74212121,213552536,69912309,1108177315,1029030472,79146843,300308119,728722353,1008859852,937520336,71339516,277485474,660034862
Wayanad,Kaziranga,Wayanad-Kaziranga,BEN_SI9,BEN_NE1,209478822,135025248,23382893,74453574,111642355,12991738,849233213,745820153,103413060,339499389,406320764,560246780,423100976,137145804,256700947,166400029
Wayanad,Kaziranga,Wayanad-Kaziranga,BEN_SI9,BEN_NE2,461953829,375411786,159413941,86542043,215997845,64479401,849233213,745820153,103413060,339499389,406320764,1250511108,1174630426,75880682,233913209,940717217
Wayanad,Kaziranga,Wayanad-Kaziranga,BEN_SI9,BEN_NE3,404317129,329245391,135015981,75071738,194229410,63788616,849233213,745820153,103413060,339499389,406320764,1008859852,937520336,71339516,277485474,660034862
Wayanad,Lalgarh,Wayanad-Lalgarh,BEN_SI1,LGS1,310323171,234519616,46005117,75803555,188514499,29556074,897358653,799698739,97659914,345341326,454357413,737843728,638009894,99833834,404772144,233237750
Wayanad,Lalgarh,Wayanad-Lalgarh,BEN_SI11,LGS1,212000915,168923643,36521061,43077272,132402582,26337246,641166204,612648765,28517439,241001807,371646958,737843728,638009894,99833834,404772144,233237750
Wayanad,Lalgarh,Wayanad-Lalgarh,BEN_SI2,LGS1,204302014,171643491,39253937,32658523,132389554,20089705,650993225,648515374,2477851,140667619,507847755,737843728,638009894,99833834,404772144,233237750
Wayanad,Lalgarh,Wayanad-Lalgarh,BEN_SI3,LGS1,310712542,236855140,57438289,73857402,179416851,26436598,931565359,847325564,84239795,345974583,501350981,737843728,638009894,99833834,404772144,233237750
Wayanad,Lalgarh,Wayanad-Lalgarh,BEN_SI4,LGS1,370442939,292441962,62175599,78000977,230266363,42621777,1109312253,1030580255,78731998,302255092,728325163,737843728,638009894,99833834,404772144,233237750
Wayanad,Lalgarh,Wayanad-Lalgarh,BEN_SI6,LGS1,322312550,249491820,58264396,72820730,191227424,38991102,951080464,864453508,86626956,319674486,544779022,737843728,638009894,99833834,404772144,233237750
Wayanad,Lalgarh,Wayanad-Lalgarh,BEN_SI7,LGS1,313839554,239355638,53551062,74483916,185804576,26441518,942430262,853584663,88845599,335397181,518187482,737843728,638009894,99833834,404772144,233237750
Wayanad,Lalgarh,Wayanad-Lalgarh,BEN_SI8,LGS1,369993959,291935595,65704185,78058364,226231410,52086043,1108177315,1029030472,79146843,300308119,728722353,737843728,638009894,99833834,404772144,233237750
Wayanad,Lalgarh,Wayanad-Lalgarh,BEN_SI9,LGS1,267473038,191154683,19041032,76318355,172113651,13769232,849233213,745820153,103413060,339499389,406320764,737843728,638009894,99833834,404772144,233237750
Wayanad,Periyar,Wayanad-Periyar,BEN_SI1,BEN_SI5,529757737,446941261,157637889,82816476,289303372,84056431,897358653,799698739,97659914,345341326,454357413,1343835283,1299687777,44147506,344660143,955027634
Wayanad,Periyar,Wayanad-Periyar,BEN_SI11,BEN_SI5,395298268,361196880,156773827,34101388,204423053,85855691,641166204,612648765,28517439,241001807,371646958,1343835283,1299687777,44147506,344660143,955027634
Wayanad,Periyar,Wayanad-Periyar,BEN_SI2,BEN_SI5,385370688,369338929,186638742,16031759,182700187,75775537,650993225,648515374,2477851,140667619,507847755,1343835283,1299687777,44147506,344660143,955027634
Wayanad,Periyar,Wayanad-Periyar,BEN_SI3,BEN_SI5,547465516,476212278,183983275,71253238,292229003,99957713,931565359,847325564,84239795,345974583,501350981,1343835283,1299687777,44147506,344660143,955027634
Wayanad,Periyar,Wayanad-Periyar,BEN_SI4,BEN_SI5,656737098,584837026,298655121,71900072,286181905,115695856,1109312253,1030580255,78731998,302255092,728325163,1343835283,1299687777,44147506,344660143,955027634
Wayanad,Periyar,Wayanad-Periyar,BEN_SI6,BEN_SI5,548876579,470723297,184853943,78153282,285869354,109371987,951080464,864453508,86626956,319674486,544779022,1343835283,1299687777,44147506,344660143,955027634
Wayanad,Periyar,Wayanad-Periyar,BEN_SI7,BEN_SI5,554057912,479559749,196672836,74498163,282886913,99126602,942430262,853584663,88845599,335397181,518187482,1343835283,1299687777,44147506,344660143,955027634
Wayanad,Periyar,Wayanad-Periyar,BEN_SI8,BEN_SI5,655546755,583390865,297002888,72155890,286387977,124238434,1108177315,1029030472,79146843,300308119,728722353,1343835283,1299687777,44147506,344660143,955027634
Wayanad,Periyar,Wayanad-Periyar,BEN_SI9,BEN_SI5,501150585,418016623,150375832,83133962,267640791,83327312,849233213,745820153,103413060,339499389,406320764,1343835283,1299687777,44147506,344660143,955027634
Wayanad,Ranthambore,Wayanad-Ranthambore,BEN_SI1,BEN_NW10,512543106,440071150,171772111,72471956,268299039,104167906,897358653,799698739,97659914,345341326,454357413,1266198710,1229664069,36534641,328923565,900740504
Wayanad,Ranthambore,Wayanad-Ranthambore,BEN_SI1,BEN_NW11,380659754,314977117,108400791,65682637,206576326,57813624,897358653,799698739,97659914,345341326,454357413,997123987,950413379,46710608,263905963,686507416
Wayanad,Ranthambore,Wayanad-Ranthambore,BEN_SI1,BEN_NW12,543231457,477596551,233320122,65634906,244276429,91393319,897358653,799698739,97659914,345341326,454357413,1267506856,1231795407,35711449,227052846,1004742561
Wayanad,Ranthambore,Wayanad-Ranthambore,BEN_SI1,BEN_NW13,486240534,420814498,163665707,65426036,257148791,106736844,897358653,799698739,97659914,345341326,454357413,1183131254,1138285233,44846021,344174628,794110605
Wayanad,Ranthambore,Wayanad-Ranthambore,BEN_SI1,BEN_NW14,501134863,433484868,219597980,67649995,213886888,92912899,897358653,799698739,97659914,345341326,454357413,1235716540,1190952996,44763544,177541519,1013411477
Wayanad,Ranthambore,Wayanad-Ranthambore,BEN_SI1,BEN_NW17,437611582,371194102,144113721,66417480,227080381,55506406,897358653,799698739,97659914,345341326,454357413,1116321554,1085802823,30518731,256140006,829662817
Wayanad,Ranthambore,Wayanad-Ranthambore,BEN_SI1,BEN_NW18,523298002,447973500,174925420,75324502,273048080,82104319,897358653,799698739,97659914,345341326,454357413,1339364699,1300736006,38628693,242877521,1057858485
Wayanad,Ranthambore,Wayanad-Ranthambore,BEN_SI1,BEN_NW19,434193281,365423023,162627552,68770258,202795471,67304384,897358653,799698739,97659914,345341326,454357413,1081768306,1036331080,45437226,232322355,804008725
Wayanad,Ranthambore,Wayanad-Ranthambore,BEN_SI1,BEN_NW20,422423946,341812350,63098067,80611596,278714283,55422180,897358653,799698739,97659914,345341326,454357413,1086271749,1022278981,63992768,541693814,480585167
Wayanad,Ranthambore,Wayanad-Ranthambore,BEN_SI1,BEN_NW24,461232675,390048637,146511676,71184038,243536961,72212855,897358653,799698739,97659914,345341326,454357413,1159641386,1113494396,46146990,301627698,811866698
Wayanad,Ranthambore,Wayanad-Ranthambore,BEN_SI1,BEN_NW3,533469953,464998704,226857794,68471249,238140910,83421096,897358653,799698739,97659914,345341326,454357413,1280728709,1240123254,40605455,207797688,1032325566
Wayanad,Ranthambore,Wayanad-Ranthambore,BEN_SI1,BEN_NW4,468258269,405569272,184492554,62688997,221076718,67665473,897358653,799698739,97659914,345341326,454357413,1219365724,1186222475,33143249,158691252,1027531223
Wayanad,Ranthambore,Wayanad-Ranthambore,BEN_SI1,BEN_NW5,379815641,313069836,100762692,66745805,212307144,63294247,897358653,799698739,97659914,345341326,454357413,977809134,918585062,59224072,241966240,676618822
Wayanad,Ranthambore,Wayanad-Ranthambore,BEN_SI1,BEN_NW55,439250034,360854884,82007387,78395150,278847497,68114357,897358653,799698739,97659914,345341326,454357413,1131174741,1073214798,57959943,534097691,539117107
Wayanad,Ranthambore,Wayanad-Ranthambore,BEN_SI1,BEN_NW57,462943169,371714118,78805679,91229051,292908439,58964000,897358653,799698739,97659914,345341326,454357413,1180288036,1103120235,77167801,638361097,464759138
Wayanad,Ranthambore,Wayanad-Ranthambore,BEN_SI1,BEN_NW6,373415442,309307419,94248377,64108023,215059042,45189743,897358653,799698739,97659914,345341326,454357413,992143483,946435718,45707765,248527765,697907953
Wayanad,Ranthambore,Wayanad-Ranthambore,BEN_SI1,BEN_NW8,471686030,400717936,154252888,70968094,246465048,78126715,897358653,799698739,97659914,345341326,454357413,1196839698,1156984240,39855458,275076038,881908202
Wayanad,Ranthambore,Wayanad-Ranthambore,BEN_SI1,BEN_NW9,496244003,424789789,192160130,71454214,232629659,92491097,897358653,799698739,97659914,345341326,454357413,1246521228,1203200533,43320695,216389572,986810961
Wayanad,Ranthambore,Wayanad-Ranthambore,BEN_SI11,BEN_NW10,350076720,319921141,121900966,30155579,198020175,56411459,641166204,612648765,28517439,241001807,371646958,1266198710,1229664069,36534641,328923565,900740504
Wayanad,Ranthambore,Wayanad-Ranthambore,BEN_SI11,BEN_NW11,276962348,248283286,93383685,28679062,154899601,54596104,641166204,612648765,28517439,241001807,371646958,997123987,950413379,46710608,263905963,686507416
Wayanad,Ranthambore,Wayanad-Ranthambore,BEN_SI11,BEN_NW12,353711476,324582610,143006020,29128866,181576590,62753722,641166204,612648765,28517439,241001807,371646958,1267506856,1231795407,35711449,227052846,1004742561
Wayanad,Ranthambore,Wayanad-Ranthambore,BEN_SI11,BEN_NW13,342653946,311846629,136747690,30807317,175098939,79778640,641166204,612648765,28517439,241001807,371646958,1183131254,1138285233,44846021,344174628,794110605
Wayanad,Ranthambore,Wayanad-Ranthambore,BEN_SI11,BEN_NW14,347224284,319918333,152645912,27305951,167272421,77161090,641166204,612648765,28517439,241001807,371646958,1235716540,1190952996,44763544,177541519,1013411477
Wayanad,Ranthambore,Wayanad-Ranthambore,BEN_SI11,BEN_NW17,317171931,290558875,126921589,26613056,163637286,69245315,641166204,612648765,28517439,241001807,371646958,1116321554,1085802823,30518731,256140006,829662817
Wayanad,Ranthambore,Wayanad-Ranthambore,BEN_SI11,BEN_NW18,381501920,352790431,172966813,28711489,179823618,79688767,641166204,612648765,28517439,241001807,371646958,1339364699,1300736006,38628693,242877521,1057858485
Wayanad,Ranthambore,Wayanad-Ranthambore,BEN_SI11,BEN_NW19,306049153,277261489,120062613,28787664,157198876,51951259,641166204,612648765,28517439,241001807,371646958,1081768306,1036331080,45437226,232322355,804008725
Wayanad,Ranthambore,Wayanad-Ranthambore,BEN_SI11,BEN_NW20,307995544,269419479,58049556,38576065,211369923,43102464,641166204,612648765,28517439,241001807,371646958,1086271749,1022278981,63992768,541693814,480585167
Wayanad,Ranthambore,Wayanad-Ranthambore,BEN_SI11,BEN_NW24,339778463,311512320,121174909,28266143,190337411,74507487,641166204,612648765,28517439,241001807,371646958,1159641386,1113494396,46146990,301627698,811866698
Wayanad,Ranthambore,Wayanad-Ranthambore,BEN_SI11,BEN_NW3,358130276,330088854,163942491,28041422,166146363,66161105,641166204,612648765,28517439,241001807,371646958,1280728709,1240123254,40605455,207797688,1032325566
Wayanad,Ranthambore,Wayanad-Ranthambore,BEN_SI11,BEN_NW4,324377247,301612892,139014956,22764355,162597936,59044044,641166204,612648765,28517439,241001807,371646958,1219365724,1186222475,33143249,158691252,1027531223
Wayanad,Ranthambore,Wayanad-Ranthambore,BEN_SI11,BEN_NW5,264730357,235964578,89526493,28765779,146438085,45982345,641166204,612648765,28517439,241001807,371646958,977809134,918585062,59224072,241966240,676618822
Wayanad,Ranthambore,Wayanad-Ranthambore,BEN_SI11,BEN_NW55,316103642,278700452,63535757,37403190,215164695,46456402,641166204,612648765,28517439,241001807,371646958,1131174741,1073214798,57959943,534097691,539117107
Wayanad,Ranthambore,Wayanad-Ranthambore,BEN_SI11,BEN_NW57,317512474,270058433,45315348,47454041,224743085,31665586,641166204,612648765,28517439,241001807,371646958,1180288036,1103120235,77167801,638361097,464759138
Wayanad,Ranthambore,Wayanad-Ranthambore,BEN_SI11,BEN_NW6,266846457,239076296,85949475,27770161,153126821,48621815,641166204,612648765,28517439,241001807,371646958,992143483,946435718,45707765,248527765,697907953
Wayanad,Ranthambore,Wayanad-Ranthambore,BEN_SI11,BEN_NW8,346304553,316523895,133225837,29780658,183298058,68692234,641166204,612648765,28517439,241001807,371646958,1196839698,1156984240,39855458,275076038,881908202
Wayanad,Ranthambore,Wayanad-Ranthambore,BEN_SI11,BEN_NW9,331057283,301001321,121727282,30055962,179274039,68926424,641166204,612648765,28517439,241001807,371646958,1246521228,1203200533,43320695,216389572,986810961
Wayanad,Ranthambore,Wayanad-Ranthambore,BEN_SI2,BEN_NW10,355128743,340625551,182611215,14503192,158014336,92119615,650993225,648515374,2477851,140667619,507847755,1266198710,1229664069,36534641,328923565,900740504
Wayanad,Ranthambore,Wayanad-Ranthambore,BEN_SI2,BEN_NW11,288471378,272375532,150256397,16095846,122119135,73791884,650993225,648515374,2477851,140667619,507847755,997123987,950413379,46710608,263905963,686507416
Wayanad,Ranthambore,Wayanad-Ranthambore,BEN_SI2,BEN_NW12,371986637,360526125,224188909,11460512,136337216,81490517,650993225,648515374,2477851,140667619,507847755,1267506856,1231795407,35711449,227052846,1004742561
Wayanad,Ranthambore,Wayanad-Ranthambore,BEN_SI2,BEN_NW13,346360075,329476909,162087963,16883166,167388946,72804933,650993225,648515374,2477851,140667619,507847755,1183131254,1138285233,44846021,344174628,794110605
Wayanad,Ranthambore,Wayanad-Ranthambore,BEN_SI2,BEN_NW14,348082366,333640653,202482161,14441713,131158492,66279759,650993225,648515374,2477851,140667619,507847755,1235716540,1190952996,44763544,177541519,1013411477
Wayanad,Ranthambore,Wayanad-Ranthambore,BEN_SI2,BEN_NW17,304140499,291624894,159290427,12515605,132334467,54652216,650993225,648515374,2477851,140667619,507847755,1116321554,1085802823,30518731,256140006,829662817
Wayanad,Ranthambore,Wayanad-Ranthambore,BEN_SI2,BEN_NW18,337006212,321773085,190636607,15233127,131136478,72385284,650993225,648515374,2477851,140667619,507847755,1339364699,1300736006,38628693,242877521,1057858485
Wayanad,Ranthambore,Wayanad-Ranthambore,BEN_SI2,BEN_NW19,290813046,274700941,150667226,16112105,124033715,48119671,650993225,648515374,2477851,140667619,507847755,1081768306,1036331080,45437226,232322355,804008725
Wayanad,Ranthambore,Wayanad-Ranthambore,BEN_SI2,BEN_NW20,275124613,251026892,66856005,24097721,184170887,51736732,650993225,648515374,2477851,140667619,507847755,1086271749,1022278981,63992768,541693814,480585167
Wayanad,Ranthambore,Wayanad-Ranthambore,BEN_SI2,BEN_NW24,323693026,306448457,147061908,17244569,159386549,84317447,650993225,648515374,2477851,140667619,507847755,1159641386,1113494396,46146990,301627698,811866698
Wayanad,Ranthambore,Wayanad-Ranthambore,BEN_SI2,BEN_NW3,342808555,326872947,202239619,15935608,124633328,74882352,650993225,648515374,2477851,140667619,507847755,1280728709,1240123254,40605455,207797688,1032325566
Wayanad,Ranthambore,Wayanad-Ranthambore,BEN_SI2,BEN_NW4,336118269,324284237,213214984,11834032,111069253,54627432,650993225,648515374,2477851,140667619,507847755,1219365724,1186222475,33143249,158691252,1027531223
Wayanad,Ranthambore,Wayanad-Ranthambore,BEN_SI2,BEN_NW5,278046174,258963278,134216773,19082896,124746505,56496839,650993225,648515374,2477851,140667619,507847755,977809134,918585062,59224072,241966240,676618822
Wayanad,Ranthambore,Wayanad-Ranthambore,BEN_SI2,BEN_NW55,321268881,299599006,118689992,21669875,180909014,63167284,650993225,648515374,2477851,140667619,507847755,1131174741,1073214798,57959943,534097691,539117107
Wayanad,Ranthambore,Wayanad-Ranthambore,BEN_SI2,BEN_NW57,327345823,297535543,84127727,29810280,213407816,57437954,650993225,648515374,2477851,140667619,507847755,1180288036,1103120235,77167801,638361097,464759138
Wayanad,Ranthambore,Wayanad-Ranthambore,BEN_SI2,BEN_NW6,268852899,252574798,129420818,16278101,123153980,55152701,650993225,648515374,2477851,140667619,507847755,992143483,946435718,45707765,248527765,697907953
Wayanad,Ranthambore,Wayanad-Ranthambore,BEN_SI2,BEN_NW8,344874076,329725217,180597702,15148859,149127515,92641231,650993225,648515374,2477851,140667619,507847755,1196839698,1156984240,39855458,275076038,881908202
Wayanad,Ranthambore,Wayanad-Ranthambore,BEN_SI2,BEN_NW9,346486042,330989767,202897730,15496275,128092037,66009504,650993225,648515374,2477851,140667619,507847755,1246521228,1203200533,43320695,216389572,986810961
Wayanad,Ranthambore,Wayanad-Ranthambore,BEN_SI3,BEN_NW10,518584010,451307330,181055463,67276680,270251867,116017989,931565359,847325564,84239795,345974583,501350981,1266198710,1229664069,36534641,328923565,900740504
Wayanad,Ranthambore,Wayanad-Ranthambore,BEN_SI3,BEN_NW11,390159788,331878744,115777501,58281044,216101243,55990906,931565359,847325564,84239795,345974583,501350981,997123987,950413379,46710608,263905963,686507416
Wayanad,Ranthambore,Wayanad-Ranthambore,BEN_SI3,BEN_NW12,528248379,463000088,226346693,65248291,236653395,108003368,931565359,847325564,84239795,345974583,501350981,1267506856,1231795407,35711449,227052846,1004742561
Wayanad,Ranthambore,Wayanad-Ranthambore,BEN_SI3,BEN_NW13,448792283,378823447,117815060,69968836,261008387,82126184,931565359,847325564,84239795,345974583,501350981,1183131254,1138285233,44846021,344174628,794110605
Wayanad,Ranthambore,Wayanad-Ranthambore,BEN_SI3,BEN_NW14,495077103,429937136,192884267,65139967,237052869,104563247,931565359,847325564,84239795,345974583,501350981,1235716540,1190952996,44763544,177541519,1013411477
Wayanad,Ranthambore,Wayanad-Ranthambore,BEN_SI3,BEN_NW17,472135625,414417788,178828460,57717837,235589328,89061577,931565359,847325564,84239795,345974583,501350981,1116321554,1085802823,30518731,256140006,829662817
Wayanad,Ranthambore,Wayanad-Ranthambore,BEN_SI3,BEN_NW18,539390937,472472825,207377587,66918112,265095238,107617808,931565359,847325564,84239795,345974583,501350981,1339364699,1300736006,38628693,242877521,1057858485
Wayanad,Ranthambore,Wayanad-Ranthambore,BEN_SI3,BEN_NW19,414767543,348897716,134077890,65869827,214819826,68280152,931565359,847325564,84239795,345974583,501350981,1081768306,1036331080,45437226,232322355,804008725
Wayanad,Ranthambore,Wayanad-Ranthambore,BEN_SI3,BEN_NW20,438074340,363617974,98603958,74456366,265014016,70989987,931565359,847325564,84239795,345974583,501350981,1086271749,1022278981,63992768,541693814,480585167
Wayanad,Ranthambore,Wayanad-Ranthambore,BEN_SI3,BEN_NW24,501879309,439701105,186438722,62178204,253262383,89493052,931565359,847325564,84239795,345974583,501350981,1159641386,1113494396,46146990,301627698,811866698
Wayanad,Ranthambore,Wayanad-Ranthambore,BEN_SI3,BEN_NW3,505091834,437745322,189958065,67346512,247787257,80736101,931565359,847325564,84239795,345974583,501350981,1280728709,1240123254,40605455,207797688,1032325566
Wayanad,Ranthambore,Wayanad-Ranthambore,BEN_SI3,BEN_NW4,492849669,435252381,205424694,57597288,229827687,74056501,931565359,847325564,84239795,345974583,501350981,1219365724,1186222475,33143249,158691252,1027531223
Wayanad,Ranthambore,Wayanad-Ranthambore,BEN_SI3,BEN_NW5,361942121,297503679,96795398,64438442,200708281,63201653,931565359,847325564,84239795,345974583,501350981,977809134,918585062,59224072,241966240,676618822
Wayanad,Ranthambore,Wayanad-Ranthambore,BEN_SI3,BEN_NW55,453661204,378795485,104860176,74865719,273935309,79936974,931565359,847325564,84239795,345974583,501350981,1131174741,1073214798,57959943,534097691,539117107
Wayanad,Ranthambore,Wayanad-Ranthambore,BEN_SI3,BEN_NW57,482421156,398459132,94810270,83962024,303648862,64166470,931565359,847325564,84239795,345974583,501350981,1180288036,1103120235,77167801,638361097,464759138
Wayanad,Ranthambore,Wayanad-Ranthambore,BEN_SI3,BEN_NW6,410223214,351328054,147524362,58895160,203803692,73411379,931565359,847325564,84239795,345974583,501350981,992143483,946435718,45707765,248527765,697907953
Wayanad,Ranthambore,Wayanad-Ranthambore,BEN_SI3,BEN_NW8,492863905,425518855,187121582,67345050,238397273,92804245,931565359,847325564,84239795,345974583,501350981,1196839698,1156984240,39855458,275076038,881908202
Wayanad,Ranthambore,Wayanad-Ranthambore,BEN_SI3,BEN_NW9,495557572,428019537,192321066,67538035,235698471,86447332,931565359,847325564,84239795,345974583,501350981,1246521228,1203200533,43320695,216389572,986810961
Wayanad,Ranthambore,Wayanad-Ranthambore,BEN_SI4,BEN_NW10,641803010,581269404,289393676,60533606,291875728,122659216,1109312253,1030580255,78731998,302255092,728325163,1266198710,1229664069,36534641,328923565,900740504
Wayanad,Ranthambore,Wayanad-Ranthambore,BEN_SI4,BEN_NW11,503874428,446853976,215456699,57020452,231397277,96675279,1109312253,1030580255,78731998,302255092,728325163,997123987,950413379,46710608,263905963,686507416
Wayanad,Ranthambore,Wayanad-Ranthambore,BEN_SI4,BEN_NW12,664920669,607768183,360354051,57152486,247414132,100843563,1109312253,1030580255,78731998,302255092,728325163,1267506856,1231795407,35711449,227052846,1004742561
Wayanad,Ranthambore,Wayanad-Ranthambore,BEN_SI4,BEN_NW13,584362337,521957715,232086312,62404622,289871403,104224917,1109312253,1030580255,78731998,302255092,728325163,1183131254,1138285233,44846021,344174628,794110605
Wayanad,Ranthambore,Wayanad-Ranthambore,BEN_SI4,BEN_NW14,673139560,618396704,396686594,54742856,221710110,111311191,1109312253,1030580255,78731998,302255092,728325163,1235716540,1190952996,44763544,177541519,1013411477
Wayanad,Ranthambore,Wayanad-Ranthambore,BEN_SI4,BEN_NW17,588242296,535615928,300416111,52626368,235199817,100321904,1109312253,1030580255,78731998,302255092,728325163,1116321554,1085802823,30518731,256140006,829662817
Wayanad,Ranthambore,Wayanad-Ranthambore,BEN_SI4,BEN_NW18,681703532,620172965,356481004,61530567,263691961,119445526,1109312253,1030580255,78731998,302255092,728325163,1339364699,1300736006,38628693,242877521,1057858485
Wayanad,Ranthambore,Wayanad-Ranthambore,BEN_SI4,BEN_NW19,559861608,501692829,284021837,58168779,217670992,99333503,1109312253,1030580255,78731998,302255092,728325163,1081768306,1036331080,45437226,232322355,804008725
Wayanad,Ranthambore,Wayanad-Ranthambore,BEN_SI4,BEN_NW20,573487235,501130254,173971699,72356981,327158555,122021172,1109312253,1030580255,78731998,302255092,728325163,1086271749,1022278981,63992768,541693814,480585167
Wayanad,Ranthambore,Wayanad-Ranthambore,BEN_SI4,BEN_NW24,577223605,516204693,233508995,61018912,282695698,117042287,1109312253,1030580255,78731998,302255092,728325163,1159641386,1113494396,46146990,301627698,811866698
Wayanad,Ranthambore,Wayanad-Ranthambore,BEN_SI4,BEN_NW3,603750966,536485599,278217407,67265367,258268192,84632238,1109312253,1030580255,78731998,302255092,728325163,1280728709,1240123254,40605455,207797688,1032325566
Wayanad,Ranthambore,Wayanad-Ranthambore,BEN_SI4,BEN_NW4,617252251,562704496,337917126,54547755,224787370,102269888,1109312253,1030580255,78731998,302255092,728325163,1219365724,1186222475,33143249,158691252,1027531223
Wayanad,Ranthambore,Wayanad-Ranthambore,BEN_SI4,BEN_NW5,477142389,414714597,193281987,62427792,221432610,77032492,1109312253,1030580255,78731998,302255092,728325163,977809134,918585062,59224072,241966240,676618822
Wayanad,Ranthambore,Wayanad-Ranthambore,BEN_SI4,BEN_NW55,591694831,522539258,183441573,69155573,339097685,101565324,1109312253,1030580255,78731998,302255092,728325163,1131174741,1073214798,57959943,534097691,539117107
Wayanad,Ranthambore,Wayanad-Ranthambore,BEN_SI4,BEN_NW57,619136443,538127593,175456990,81008850,362670603,112267095,1109312253,1030580255,78731998,302255092,728325163,1180288036,1103120235,77167801,638361097,464759138
Wayanad,Ranthambore,Wayanad-Ranthambore,BEN_SI4,BEN_NW6,504277770,448997253,222843285,55280517,226153968,78957567,1109312253,1030580255,78731998,302255092,728325163,992143483,946435718,45707765,248527765,697907953
Wayanad,Ranthambore,Wayanad-Ranthambore,BEN_SI4,BEN_NW8,594368843,530955346,266196633,63413497,264758713,106850961,1109312253,1030580255,78731998,302255092,728325163,1196839698,1156984240,39855458,275076038,881908202
Wayanad,Ranthambore,Wayanad-Ranthambore,BEN_SI4,BEN_NW9,618626280,554888537,296914125,63737743,257974412,116934978,1109312253,1030580255,78731998,302255092,728325163,1246521228,1203200533,43320695,216389572,986810961
Wayanad,Ranthambore,Wayanad-Ranthambore,BEN_SI6,BEN_NW10,529852369,459620272,172947706,70232097,286672566,107021371,951080464,864453508,86626956,319674486,544779022,1266198710,1229664069,36534641,328923565,900740504
Wayanad,Ranthambore,Wayanad-Ranthambore,BEN_SI6,BEN_NW11,408207529,347729737,129917221,60477792,217812516,72999259,951080464,864453508,86626956,319674486,544779022,997123987,950413379,46710608,263905963,686507416
Wayanad,Ranthambore,Wayanad-Ranthambore,BEN_SI6,BEN_NW12,543888530,481992637,211395149,61895893,270597488,87185062,951080464,864453508,86626956,319674486,544779022,1267506856,1231795407,35711449,227052846,1004742561
Wayanad,Ranthambore,Wayanad-Ranthambore,BEN_SI6,BEN_NW13,495849522,430936691,171787038,64912831,259149653,109205239,951080464,864453508,86626956,319674486,544779022,1183131254,1138285233,44846021,344174628,794110605
Wayanad,Ranthambore,Wayanad-Ranthambore,BEN_SI6,BEN_NW14,527395587,467755477,241006608,59640110,226748869,91706137,951080464,864453508,86626956,319674486,544779022,1235716540,1190952996,44763544,177541519,1013411477
Wayanad,Ranthambore,Wayanad-Ranthambore,BEN_SI6,BEN_NW17,457189911,393451672,167350354,63738239,226101318,74633892,951080464,864453508,86626956,319674486,544779022,1116321554,1085802823,30518731,256140006,829662817
Wayanad,Ranthambore,Wayanad-Ranthambore,BEN_SI6,BEN_NW18,550680263,480510210,216930464,70170053,263579746,106360613,951080464,864453508,86626956,319674486,544779022,1339364699,1300736006,38628693,242877521,1057858485
Wayanad,Ranthambore,Wayanad-Ranthambore,BEN_SI6,BEN_NW19,460334811,398275322,198160659,62059489,200114663,74814069,951080464,864453508,86626956,319674486,544779022,1081768306,1036331080,45437226,232322355,804008725
Wayanad,Ranthambore,Wayanad-Ranthambore,BEN_SI6,BEN_NW20,475579348,403921781,129141144,71657567,274780637,92902780,951080464,864453508,86626956,319674486,544779022,1086271749,1022278981,63992768,541693814,480585167
Wayanad,Ranthambore,Wayanad-Ranthambore,BEN_SI6,BEN_NW24,500691089,436661971,190109681,64029118,246552290,75651418,951080464,864453508,86626956,319674486,544779022,1159641386,1113494396,46146990,301627698,811866698
Wayanad,Ranthambore,Wayanad-Ranthambore,BEN_SI6,BEN_NW3,555466075,489731931,253428533,65734144,236303398,96533377,951080464,864453508,86626956,319674486,544779022,1280728709,1240123254,40605455,207797688,1032325566
Wayanad,Ranthambore,Wayanad-Ranthambore,BEN_SI6,BEN_NW4,522054711,466343642,246800565,55711069,219543077,79508939,951080464,864453508,86626956,319674486,544779022,1219365724,1186222475,33143249,158691252,1027531223
Wayanad,Ranthambore,Wayanad-Ranthambore,BEN_SI6,BEN_NW5,399194758,336533289,150234816,62661469,186298473,59718291,951080464,864453508,86626956,319674486,544779022,977809134,918585062,59224072,241966240,676618822
Wayanad,Ranthambore,Wayanad-Ranthambore,BEN_SI6,BEN_NW55,491348749,416910120,143929522,74438629,272980598,95786057,951080464,864453508,86626956,319674486,544779022,1131174741,1073214798,57959943,534097691,539117107
Wayanad,Ranthambore,Wayanad-Ranthambore,BEN_SI6,BEN_NW57,515526628,431712221,112424027,83814407,319288194,81278595,951080464,864453508,86626956,319674486,544779022,1180288036,1103120235,77167801,638361097,464759138
Wayanad,Ranthambore,Wayanad-Ranthambore,BEN_SI6,BEN_NW6,404089623,345215000,128938331,58874623,216276669,70872872,951080464,864453508,86626956,319674486,544779022,992143483,946435718,45707765,248527765,697907953
Wayanad,Ranthambore,Wayanad-Ranthambore,BEN_SI6,BEN_NW8,486130973,420942897,179529124,65188076,241413773,82731871,951080464,864453508,86626956,319674486,544779022,1196839698,1156984240,39855458,275076038,881908202
Wayanad,Ranthambore,Wayanad-Ranthambore,BEN_SI6,BEN_NW9,528075466,464945295,224577798,63130171,240367497,96834145,951080464,864453508,86626956,319674486,544779022,1246521228,1203200533,43320695,216389572,986810961
Wayanad,Ranthambore,Wayanad-Ranthambore,BEN_SI7,BEN_NW10,522681322,452428201,184580582,70253121,267847619,111971392,942430262,853584663,88845599,335397181,518187482,1266198710,1229664069,36534641,328923565,900740504
Wayanad,Ranthambore,Wayanad-Ranthambore,BEN_SI7,BEN_NW11,394665289,334066947,118080212,60598342,215986735,51452571,942430262,853584663,88845599,335397181,518187482,997123987,950413379,46710608,263905963,686507416
Wayanad,Ranthambore,Wayanad-Ranthambore,BEN_SI7,BEN_NW12,533679086,465059693,228158126,68619393,236901567,96860374,942430262,853584663,88845599,335397181,518187482,1267506856,1231795407,35711449,227052846,1004742561
Wayanad,Ranthambore,Wayanad-Ranthambore,BEN_SI7,BEN_NW13,452904840,381627249,117112881,71277591,264514368,77483891,942430262,853584663,88845599,335397181,518187482,1183131254,1138285233,44846021,344174628,794110605
Wayanad,Ranthambore,Wayanad-Ranthambore,BEN_SI7,BEN_NW14,502469072,434267003,197398086,68202069,236868917,93104985,942430262,853584663,88845599,335397181,518187482,1235716540,1190952996,44763544,177541519,1013411477
Wayanad,Ranthambore,Wayanad-Ranthambore,BEN_SI7,BEN_NW17,477717750,417771120,186111772,59946630,231659348,96430067,942430262,853584663,88845599,335397181,518187482,1116321554,1085802823,30518731,256140006,829662817
Wayanad,Ranthambore,Wayanad-Ranthambore,BEN_SI7,BEN_NW18,545320596,474891205,209420234,70429391,265470971,97914812,942430262,853584663,88845599,335397181,518187482,1339364699,1300736006,38628693,242877521,1057858485
Wayanad,Ranthambore,Wayanad-Ranthambore,BEN_SI7,BEN_NW19,421952602,353487521,133929172,68465081,219558349,63306283,942430262,853584663,88845599,335397181,518187482,1081768306,1036331080,45437226,232322355,804008725
Wayanad,Ranthambore,Wayanad-Ranthambore,BEN_SI7,BEN_NW20,442835378,366051871,90924894,76783507,275126977,60025892,942430262,853584663,88845599,335397181,518187482,1086271749,1022278981,63992768,541693814,480585167
Wayanad,Ranthambore,Wayanad-Ranthambore,BEN_SI7,BEN_NW24,507343035,443802413,192644895,63540622,251157518,91136878,942430262,853584663,88845599,335397181,518187482,1159641386,1113494396,46146990,301627698,811866698
Wayanad,Ranthambore,Wayanad-Ranthambore,BEN_SI7,BEN_NW3,511743705,441187898,199201563,70555807,241986335,74227046,942430262,853584663,88845599,335397181,518187482,1280728709,1240123254,40605455,207797688,1032325566
Wayanad,Ranthambore,Wayanad-Ranthambore,BEN_SI7,BEN_NW4,498234703,437073919,209354920,61160784,227718999,68477292,942430262,853584663,88845599,335397181,518187482,1219365724,1186222475,33143249,158691252,1027531223
Wayanad,Ranthambore,Wayanad-Ranthambore,BEN_SI7,BEN_NW5,366426121,299767780,98747282,66658341,201020498,59650175,942430262,853584663,88845599,335397181,518187482,977809134,918585062,59224072,241966240,676618822
Wayanad,Ranthambore,Wayanad-Ranthambore,BEN_SI7,BEN_NW55,459317131,382525359,101155109,76791772,281370250,75327834,942430262,853584663,88845599,335397181,518187482,1131174741,1073214798,57959943,534097691,539117107
Wayanad,Ranthambore,Wayanad-Ranthambore,BEN_SI7,BEN_NW57,487912630,400121346,90607083,87791284,309514263,57849979,942430262,853584663,88845599,335397181,518187482,1180288036,1103120235,77167801,638361097,464759138
Wayanad,Ranthambore,Wayanad-Ranthambore,BEN_SI7,BEN_NW6,415628155,354170254,139728727,61457901,214441527,65607771,942430262,853584663,88845599,335397181,518187482,992143483,946435718,45707765,248527765,697907953
Wayanad,Ranthambore,Wayanad-Ranthambore,BEN_SI7,BEN_NW8,498001144,428107216,196260888,69893928,231846328,93641720,942430262,853584663,88845599,335397181,518187482,1196839698,1156984240,39855458,275076038,881908202
Wayanad,Ranthambore,Wayanad-Ranthambore,BEN_SI7,BEN_NW9,501042046,431137614,194729200,69904432,236408414,74835113,942430262,853584663,88845599,335397181,518187482,1246521228,1203200533,43320695,216389572,986810961
Wayanad,Ranthambore,Wayanad-Ranthambore,BEN_SI8,BEN_NW10,641715437,580338933,285492959,61376504,294845974,125402613,1108177315,1029030472,79146843,300308119,728722353,1266198710,1229664069,36534641,328923565,900740504
Wayanad,Ranthambore,Wayanad-Ranthambore,BEN_SI8,BEN_NW11,503121033,445635340,204949104,57485693,240686236,86027739,1108177315,1029030472,79146843,300308119,728722353,997123987,950413379,46710608,263905963,686507416
Wayanad,Ranthambore,Wayanad-Ranthambore,BEN_SI8,BEN_NW12,664083628,605695781,354383380,58387847,251312401,105307080,1108177315,1029030472,79146843,300308119,728722353,1267506856,1231795407,35711449,227052846,1004742561
Wayanad,Ranthambore,Wayanad-Ranthambore,BEN_SI8,BEN_NW13,583940321,520729826,230813015,63210495,289916811,109354176,1108177315,1029030472,79146843,300308119,728722353,1183131254,1138285233,44846021,344174628,794110605
Wayanad,Ranthambore,Wayanad-Ranthambore,BEN_SI8,BEN_NW14,673920884,618388396,404498216,55532488,213890180,111712917,1108177315,1029030472,79146843,300308119,728722353,1235716540,1190952996,44763544,177541519,1013411477
Wayanad,Ranthambore,Wayanad-Ranthambore,BEN_SI8,BEN_NW17,588128119,534932996,300858279,53195123,234074717,110135496,1108177315,1029030472,79146843,300308119,728722353,1116321554,1085802823,30518731,256140006,829662817
Wayanad,Ranthambore,Wayanad-Ranthambore,BEN_SI8,BEN_NW18,681851613,618070220,360570091,63781393,257500129,130199564,1108177315,1029030472,79146843,300308119,728722353,1339364699,1300736006,38628693,242877521,1057858485
Wayanad,Ranthambore,Wayanad-Ranthambore,BEN_SI8,BEN_NW19,559574048,500849542,280811423,58724506,220038119,101386846,1108177315,1029030472,79146843,300308119,728722353,1081768306,1036331080,45437226,232322355,804008725
Wayanad,Ranthambore,Wayanad-Ranthambore,BEN_SI8,BEN_NW20,574521281,502385493,176274661,72135788,326110832,137151671,1108177315,1029030472,79146843,300308119,728722353,1086271749,1022278981,63992768,541693814,480585167
Wayanad,Ranthambore,Wayanad-Ranthambore,BEN_SI8,BEN_NW24,577960719,515434937,247674789,62525782,267760148,118704603,1108177315,1029030472,79146843,300308119,728722353,1159641386,1113494396,46146990,301627698,811866698
Wayanad,Ranthambore,Wayanad-Ranthambore,BEN_SI8,BEN_NW3,603561150,535369304,272377005,68191846,262992299,92398500,1108177315,1029030472,79146843,300308119,728722353,1280728709,1240123254,40605455,207797688,1032325566
Wayanad,Ranthambore,Wayanad-Ranthambore,BEN_SI8,BEN_NW4,616835015,561936888,338511570,54898127,223425318,98841192,1108177315,1029030472,79146843,300308119,728722353,1219365724,1186222475,33143249,158691252,1027531223
Wayanad,Ranthambore,Wayanad-Ranthambore,BEN_SI8,BEN_NW5,476287141,413022603,195433864,63264538,217588739,75308319,1108177315,1029030472,79146843,300308119,728722353,977809134,918585062,59224072,241966240,676618822
Wayanad,Ranthambore,Wayanad-Ranthambore,BEN_SI8,BEN_NW55,592219507,522497651,180622446,69721856,341875205,104044676,1108177315,1029030472,79146843,300308119,728722353,1131174741,1073214798,57959943,534097691,539117107
Wayanad,Ranthambore,Wayanad-Ranthambore,BEN_SI8,BEN_NW57,619270592,538634861,175336944,80635731,363297917,108542298,1108177315,1029030472,79146843,300308119,728722353,1180288036,1103120235,77167801,638361097,464759138
Wayanad,Ranthambore,Wayanad-Ranthambore,BEN_SI8,BEN_NW6,504552782,449508797,220193683,55043985,229315114,77991213,1108177315,1029030472,79146843,300308119,728722353,992143483,946435718,45707765,248527765,697907953
Wayanad,Ranthambore,Wayanad-Ranthambore,BEN_SI8,BEN_NW8,593145911,529282194,261514502,63863717,267767692,109126223,1108177315,1029030472,79146843,300308119,728722353,1196839698,1156984240,39855458,275076038,881908202
Wayanad,Ranthambore,Wayanad-Ranthambore,BEN_SI8,BEN_NW9,616979389,553149027,287325577,63830362,265823450,112722176,1108177315,1029030472,79146843,300308119,728722353,1246521228,1203200533,43320695,216389572,986810961
Wayanad,Ranthambore,Wayanad-Ranthambore,BEN_SI9,BEN_NW10,479572649,403675284,148184575,75897365,255490709,85927616,849233213,745820153,103413060,339499389,406320764,1266198710,1229664069,36534641,328923565,900740504
Wayanad,Ranthambore,Wayanad-Ranthambore,BEN_SI9,BEN_NW11,366404133,304127284,111983431,62276849,192143853,52211458,849233213,745820153,103413060,339499389,406320764,997123987,950413379,46710608,263905963,686507416
Wayanad,Ranthambore,Wayanad-Ranthambore,BEN_SI9,BEN_NW12,494793495,427811989,194960147,66981506,232851842,80735533,849233213,745820153,103413060,339499389,406320764,1267506856,1231795407,35711449,227052846,1004742561
Wayanad,Ranthambore,Wayanad-Ranthambore,BEN_SI9,BEN_NW13,447369413,377299519,131083635,70069894,246215884,78435826,849233213,745820153,103413060,339499389,406320764,1183131254,1138285233,44846021,344174628,794110605
Wayanad,Ranthambore,Wayanad-Ranthambore,BEN_SI9,BEN_NW14,466531162,398172788,175589577,68358374,222583211,84589306,849233213,745820153,103413060,339499389,406320764,1235716540,1190952996,44763544,177541519,1013411477
Wayanad,Ranthambore,Wayanad-Ranthambore,BEN_SI9,BEN_NW17,398870601,332709232,107966301,66161369,224742931,63502687,849233213,745820153,103413060,339499389,406320764,1116321554,1085802823,30518731,256140006,829662817
Wayanad,Ranthambore,Wayanad-Ranthambore,BEN_SI9,BEN_NW18,509939637,434558349,190422256,75381288,244136093,82963542,849233213,745820153,103413060,339499389,406320764,1339364699,1300736006,38628693,242877521,1057858485
Wayanad,Ranthambore,Wayanad-Ranthambore,BEN_SI9,BEN_NW19,390675662,320630560,117237783,70045102,203392777,41142282,849233213,745820153,103413060,339499389,406320764,1081768306,1036331080,45437226,232322355,804008725
Wayanad,Ranthambore,Wayanad-Ranthambore,BEN_SI9,BEN_NW20,400691623,319161072,90338129,81530551,228822943,62234594,849233213,745820153,103413060,339499389,406320764,1086271749,1022278981,63992768,541693814,480585167
Wayanad,Ranthambore,Wayanad-Ranthambore,BEN_SI9,BEN_NW24,431773837,358835215,119959850,72938622,238875365,78495122,849233213,745820153,103413060,339499389,406320764,1159641386,1113494396,46146990,301627698,811866698
Wayanad,Ranthambore,Wayanad-Ranthambore,BEN_SI9,BEN_NW3,494485979,422111022,197809709,72374957,224301313,85614475,849233213,745820153,103413060,339499389,406320764,1280728709,1240123254,40605455,207797688,1032325566
Wayanad,Ranthambore,Wayanad-Ranthambore,BEN_SI9,BEN_NW4,469698849,404550356,200573195,65148493,203977161,66846137,849233213,745820153,103413060,339499389,406320764,1219365724,1186222475,33143249,158691252,1027531223
Wayanad,Ranthambore,Wayanad-Ranthambore,BEN_SI9,BEN_NW5,351863104,283492948,98790934,68370156,184702014,50112188,849233213,745820153,103413060,339499389,406320764,977809134,918585062,59224072,241966240,676618822
Wayanad,Ranthambore,Wayanad-Ranthambore,BEN_SI9,BEN_NW55,427374124,350877700,90425739,76496424,260451961,62843894,849233213,745820153,103413060,339499389,406320764,1131174741,1073214798,57959943,534097691,539117107
Wayanad,Ranthambore,Wayanad-Ranthambore,BEN_SI9,BEN_NW57,442886549,353452868,80669897,89433681,272782971,64162278,849233213,745820153,103413060,339499389,406320764,1180288036,1103120235,77167801,638361097,464759138
Wayanad,Ranthambore,Wayanad-Ranthambore,BEN_SI9,BEN_NW6,394960320,333595544,143815786,61364776,189779758,55627440,849233213,745820153,103413060,339499389,406320764,992143483,946435718,45707765,248527765,697907953
Wayanad,Ranthambore,Wayanad-Ranthambore,BEN_SI9,BEN_NW8,460725000,391802523,162745390,68922477,229057133,62523331,849233213,745820153,103413060,339499389,406320764,1196839698,1156984240,39855458,275076038,881908202
Wayanad,Ranthambore,Wayanad-Ranthambore,BEN_SI9,BEN_NW9,464939502,393266153,179612344,71673349,213653809,81966155,849233213,745820153,103413060,339499389,406320764,1246521228,1203200533,43320695,216389572,986810961
Wayanad,Wayanad,Wayanad-Wayanad,BEN_SI1,BEN_SI11,291227576,249888736,93192118,41338840,156696618,53020739,897358653,799698739,97659914,345341326,454357413,641166204,612648765,28517439,241001807,371646958
Wayanad,Wayanad,Wayanad-Wayanad,BEN_SI1,BEN_SI2,290659145,261550401,133874619,29108744,127675782,52088940,897358653,799698739,97659914,345341326,454357413,650993225,648515374,2477851,140667619,507847755
Wayanad,Wayanad,Wayanad-Wayanad,BEN_SI1,BEN_SI3,430800884,353707149,127570574,77093735,226136575,50497094,897358653,799698739,97659914,345341326,454357413,931565359,847325564,84239795,345974583,501350981
Wayanad,Wayanad,Wayanad-Wayanad,BEN_SI1,BEN_SI4,473482246,386512330,139940474,86969916,246571856,64631899,897358653,799698739,97659914,345341326,454357413,1109312253,1030580255,78731998,302255092,728325163
Wayanad,Wayanad,Wayanad-Wayanad,BEN_SI1,BEN_SI6,486155212,407465552,164383017,78689660,243082535,61196262,897358653,799698739,97659914,345341326,454357413,951080464,864453508,86626956,319674486,544779022
Wayanad,Wayanad,Wayanad-Wayanad,BEN_SI1,BEN_SI7,435092827,354948717,131462020,80144110,223486697,46498817,897358653,799698739,97659914,345341326,454357413,942430262,853584663,88845599,335397181,518187482
Wayanad,Wayanad,Wayanad-Wayanad,BEN_SI1,BEN_SI8,472345658,385013897,139838167,87331761,245175730,53375233,897358653,799698739,97659914,345341326,454357413,1108177315,1029030472,79146843,300308119,728722353
Wayanad,Wayanad,Wayanad-Wayanad,BEN_SI1,BEN_SI9,381727863,300247282,111026611,81480581,189220671,43893366,897358653,799698739,97659914,345341326,454357413,849233213,745820153,103413060,339499389,406320764
Wayanad,Wayanad,Wayanad-Wayanad,BEN_SI11,BEN_SI1,291227576,249888736,93192118,41338840,156696618,53020739,641166204,612648765,28517439,241001807,371646958,897358653,799698739,97659914,345341326,454357413
Wayanad,Wayanad,Wayanad-Wayanad,BEN_SI11,BEN_SI2,207125097,197304799,92571221,9820298,104733578,49237095,641166204,612648765,28517439,241001807,371646958,650993225,648515374,2477851,140667619,507847755
Wayanad,Wayanad,Wayanad-Wayanad,BEN_SI11,BEN_SI3,314411079,278232122,97830531,36178957,180401591,53854929,641166204,612648765,28517439,241001807,371646958,931565359,847325564,84239795,345974583,501350981
Wayanad,Wayanad,Wayanad-Wayanad,BEN_SI11,BEN_SI4,364502603,329126718,148115348,35375885,181011370,55986715,641166204,612648765,28517439,241001807,371646958,1109312253,1030580255,78731998,302255092,728325163
Wayanad,Wayanad,Wayanad-Wayanad,BEN_SI11,BEN_SI6,285457751,245257598,89425838,40200153,155831760,52167738,641166204,612648765,28517439,241001807,371646958,951080464,864453508,86626956,319674486,544779022
Wayanad,Wayanad,Wayanad-Wayanad,BEN_SI11,BEN_SI7,316412330,278980748,106214058,37431582,172766690,54542697,641166204,612648765,28517439,241001807,371646958,942430262,853584663,88845599,335397181,518187482
Wayanad,Wayanad,Wayanad-Wayanad,BEN_SI11,BEN_SI8,364643890,328769440,152318071,35874450,176451369,56666929,641166204,612648765,28517439,241001807,371646958,1108177315,1029030472,79146843,300308119,728722353
Wayanad,Wayanad,Wayanad-Wayanad,BEN_SI11,BEN_SI9,237538896,196793131,48332829,40745765,148460302,32792807,641166204,612648765,28517439,241001807,371646958,849233213,745820153,103413060,339499389,406320764
Wayanad,Wayanad,Wayanad-Wayanad,BEN_SI2,BEN_SI1,290659145,261550401,133874619,29108744,127675782,52088940,650993225,648515374,2477851,140667619,507847755,897358653,799698739,97659914,345341326,454357413
Wayanad,Wayanad,Wayanad-Wayanad,BEN_SI2,BEN_SI11,207125097,197304799,92571221,9820298,104733578,49237095,650993225,648515374,2477851,140667619,507847755,641166204,612648765,28517439,241001807,371646958
Wayanad,Wayanad,Wayanad-Wayanad,BEN_SI2,BEN_SI3,281004046,255219922,112785958,25784124,142433964,50650007,650993225,648515374,2477851,140667619,507847755,931565359,847325564,84239795,345974583,501350981
Wayanad,Wayanad,Wayanad-Wayanad,BEN_SI2,BEN_SI4,312207183,287106734,151806880,25100449,135299854,70286328,650993225,648515374,2477851,140667619,507847755,1109312253,1030580255,78731998,302255092,728325163
Wayanad,Wayanad,Wayanad-Wayanad,BEN_SI2,BEN_SI6,304601412,279839849,145868493,24761563,133971356,53386492,650993225,648515374,2477851,140667619,507847755,951080464,864453508,86626956,319674486,544779022
Wayanad,Wayanad,Wayanad-Wayanad,BEN_SI2,BEN_SI7,283145762,254725378,117173792,28420384,137551586,44259493,650993225,648515374,2477851,140667619,507847755,942430262,853584663,88845599,335397181,518187482
Wayanad,Wayanad,Wayanad-Wayanad,BEN_SI2,BEN_SI8,312307393,286544496,138799262,25762897,147745234,55635092,650993225,648515374,2477851,140667619,507847755,1108177315,1029030472,79146843,300308119,728722353
Wayanad,Wayanad,Wayanad-Wayanad,BEN_SI2,BEN_SI9,272127294,241968953,99305322,30158341,142663631,58712441,650993225,648515374,2477851,140667619,507847755,849233213,745820153,103413060,339499389,406320764
Wayanad,Wayanad,Wayanad-Wayanad,BEN_SI3,BEN_SI1,430800884,353707149,127570574,77093735,226136575,50497094,931565359,847325564,84239795,345974583,501350981,897358653,799698739,97659914,345341326,454357413
Wayanad,Wayanad,Wayanad-Wayanad,BEN_SI3,BEN_SI11,314411079,278232122,97830531,36178957,180401591,53854929,931565359,847325564,84239795,345974583,501350981,641166204,612648765,28517439,241001807,371646958
Wayanad,Wayanad,Wayanad-Wayanad,BEN_SI3,BEN_SI2,281004046,255219922,112785958,25784124,142433964,50650007,931565359,847325564,84239795,345974583,501350981,650993225,648515374,2477851,140667619,507847755
Wayanad,Wayanad,Wayanad-Wayanad,BEN_SI3,BEN_SI4,513639891,434006963,168685763,79632928,265321200,74997703,931565359,847325564,84239795,345974583,501350981,1109312253,1030580255,78731998,302255092,728325163
Wayanad,Wayanad,Wayanad-Wayanad,BEN_SI3,BEN_SI6,427005603,348097060,115759647,78908543,232337413,50315545,931565359,847325564,84239795,345974583,501350981,951080464,864453508,86626956,319674486,544779022
Wayanad,Wayanad,Wayanad-Wayanad,BEN_SI3,BEN_SI7,912877261,827306459,468827518,85570802,358478941,160431658,931565359,847325564,84239795,345974583,501350981,942430262,853584663,88845599,335397181,518187482
Wayanad,Wayanad,Wayanad-Wayanad,BEN_SI3,BEN_SI8,514128257,432941117,162514916,81187140,270426201,77016898,931565359,847325564,84239795,345974583,501350981,1108177315,1029030472,79146843,300308119,728722353
Wayanad,Wayanad,Wayanad-Wayanad,BEN_SI3,BEN_SI9,404037588,326691641,141742962,77345947,184948679,50531959,931565359,847325564,84239795,345974583,501350981,849233213,745820153,103413060,339499389,406320764
Wayanad,Wayanad,Wayanad-Wayanad,BEN_SI4,BEN_SI1,473482246,386512330,139940474,86969916,246571856,64631899,1109312253,1030580255,78731998,302255092,728325163,897358653,799698739,97659914,345341326,454357413
Wayanad,Wayanad,Wayanad-Wayanad,BEN_SI4,BEN_SI11,364502603,329126718,148115348,35375885,181011370,55986715,1109312253,1030580255,78731998,302255092,728325163,641166204,612648765,28517439,241001807,371646958
Wayanad,Wayanad,Wayanad-Wayanad,BEN_SI4,BEN_SI2,312207183,287106734,151806880,25100449,135299854,70286328,1109312253,1030580255,78731998,302255092,728325163,650993225,648515374,2477851,140667619,507847755
Wayanad,Wayanad,Wayanad-Wayanad,BEN_SI4,BEN_SI3,513639891,434006963,168685763,79632928,265321200,74997703,1109312253,1030580255,78731998,302255092,728325163,931565359,847325564,84239795,345974583,501350981
Wayanad,Wayanad,Wayanad-Wayanad,BEN_SI4,BEN_SI6,537388784,458939333,207521546,78449451,251417787,77729200,1109312253,1030580255,78731998,302255092,728325163,951080464,864453508,86626956,319674486,544779022
Wayanad,Wayanad,Wayanad-Wayanad,BEN_SI4,BEN_SI7,521504625,437152554,165445146,84352071,271707408,55813224,1109312253,1030580255,78731998,302255092,728325163,942430262,853584663,88845599,335397181,518187482
Wayanad,Wayanad,Wayanad-Wayanad,BEN_SI4,BEN_SI8,1089840647,1011827339,687243004,78013308,324584335,172314985,1109312253,1030580255,78731998,302255092,728325163,1108177315,1029030472,79146843,300308119,728722353
Wayanad,Wayanad,Wayanad-Wayanad,BEN_SI4,BEN_SI9,449321887,366234833,143937002,83087054,222297831,69441771,1109312253,1030580255,78731998,302255092,728325163,849233213,745820153,103413060,339499389,406320764
Wayanad,Wayanad,Wayanad-Wayanad,BEN_SI6,BEN_SI1,486155212,407465552,164383017,78689660,243082535,61196262,951080464,864453508,86626956,319674486,544779022,897358653,799698739,97659914,345341326,454357413
Wayanad,Wayanad,Wayanad-Wayanad,BEN_SI6,BEN_SI11,285457751,245257598,89425838,40200153,155831760,52167738,951080464,864453508,86626956,319674486,544779022,641166204,612648765,28517439,241001807,371646958
Wayanad,Wayanad,Wayanad-Wayanad,BEN_SI6,BEN_SI2,304601412,279839849,145868493,24761563,133971356,53386492,951080464,864453508,86626956,319674486,544779022,650993225,648515374,2477851,140667619,507847755
Wayanad,Wayanad,Wayanad-Wayanad,BEN_SI6,BEN_SI3,427005603,348097060,115759647,78908543,232337413,50315545,951080464,864453508,86626956,319674486,544779022,931565359,847325564,84239795,345974583,501350981
Wayanad,Wayanad,Wayanad-Wayanad,BEN_SI6,BEN_SI4,537388784,458939333,207521546,78449451,251417787,77729200,951080464,864453508,86626956,319674486,544779022,1109312253,1030580255,78731998,302255092,728325163
Wayanad,Wayanad,Wayanad-Wayanad,BEN_SI6,BEN_SI7,431773454,350171473,122077223,81601981,228094250,52049529,951080464,864453508,86626956,319674486,544779022,942430262,853584663,88845599,335397181,518187482
Wayanad,Wayanad,Wayanad-Wayanad,BEN_SI6,BEN_SI8,535713328,456202582,204801356,79510746,251401226,78873634,951080464,864453508,86626956,319674486,544779022,1108177315,1029030472,79146843,300308119,728722353
Wayanad,Wayanad,Wayanad-Wayanad,BEN_SI6,BEN_SI9,389236271,311770657,108689743,77465614,203080914,43306541,951080464,864453508,86626956,319674486,544779022,849233213,745820153,103413060,339499389,406320764
Wayanad,Wayanad,Wayanad-Wayanad,BEN_SI7,BEN_SI1,435092827,354948717,131462020,80144110,223486697,46498817,942430262,853584663,88845599,335397181,518187482,897358653,799698739,97659914,345341326,454357413
Wayanad,Wayanad,Wayanad-Wayanad,BEN_SI7,BEN_SI11,316412330,278980748,106214058,37431582,172766690,54542697,942430262,853584663,88845599,335397181,518187482,641166204,612648765,28517439,241001807,371646958
Wayanad,Wayanad,Wayanad-Wayanad,BEN_SI7,BEN_SI2,283145762,254725378,117173792,28420384,137551586,44259493,942430262,853584663,88845599,335397181,518187482,650993225,648515374,2477851,140667619,507847755
Wayanad,Wayanad,Wayanad-Wayanad,BEN_SI7,BEN_SI3,912877261,827306459,468827518,85570802,358478941,160431658,942430262,853584663,88845599,335397181,518187482,931565359,847325564,84239795,345974583,501350981
Wayanad,Wayanad,Wayanad-Wayanad,BEN_SI7,BEN_SI4,521504625,437152554,165445146,84352071,271707408,55813224,942430262,853584663,88845599,335397181,518187482,1109312253,1030580255,78731998,302255092,728325163
Wayanad,Wayanad,Wayanad-Wayanad,BEN_SI7,BEN_SI6,431773454,350171473,122077223,81601981,228094250,52049529,942430262,853584663,88845599,335397181,518187482,951080464,864453508,86626956,319674486,544779022
Wayanad,Wayanad,Wayanad-Wayanad,BEN_SI7,BEN_SI8,521861909,436745066,167214710,85116843,269530356,67588052,942430262,853584663,88845599,335397181,518187482,1108177315,1029030472,79146843,300308119,728722353
Wayanad,Wayanad,Wayanad-Wayanad,BEN_SI7,BEN_SI9,408452890,328651939,145062796,79800951,183589143,52858911,942430262,853584663,88845599,335397181,518187482,849233213,745820153,103413060,339499389,406320764
Wayanad,Wayanad,Wayanad-Wayanad,BEN_SI8,BEN_SI1,472345658,385013897,139838167,87331761,245175730,53375233,1108177315,1029030472,79146843,300308119,728722353,897358653,799698739,97659914,345341326,454357413
Wayanad,Wayanad,Wayanad-Wayanad,BEN_SI8,BEN_SI11,364643890,328769440,152318071,35874450,176451369,56666929,1108177315,1029030472,79146843,300308119,728722353,641166204,612648765,28517439,241001807,371646958
Wayanad,Wayanad,Wayanad-Wayanad,BEN_SI8,BEN_SI2,312307393,286544496,138799262,25762897,147745234,55635092,1108177315,1029030472,79146843,300308119,728722353,650993225,648515374,2477851,140667619,507847755
Wayanad,Wayanad,Wayanad-Wayanad,BEN_SI8,BEN_SI3,514128257,432941117,162514916,81187140,270426201,77016898,1108177315,1029030472,79146843,300308119,728722353,931565359,847325564,84239795,345974583,501350981
Wayanad,Wayanad,Wayanad-Wayanad,BEN_SI8,BEN_SI4,1089840647,1011827339,687243004,78013308,324584335,172314985,1108177315,1029030472,79146843,300308119,728722353,1109312253,1030580255,78731998,302255092,728325163
Wayanad,Wayanad,Wayanad-Wayanad,BEN_SI8,BEN_SI6,535713328,456202582,204801356,79510746,251401226,78873634,1108177315,1029030472,79146843,300308119,728722353,951080464,864453508,86626956,319674486,544779022
Wayanad,Wayanad,Wayanad-Wayanad,BEN_SI8,BEN_SI7,521861909,436745066,167214710,85116843,269530356,67588052,1108177315,1029030472,79146843,300308119,728722353,942430262,853584663,88845599,335397181,518187482
Wayanad,Wayanad,Wayanad-Wayanad,BEN_SI8,BEN_SI9,450118463,366331298,140553460,83787165,225777838,67011138,1108177315,1029030472,79146843,300308119,728722353,849233213,745820153,103413060,339499389,406320764
Wayanad,Wayanad,Wayanad-Wayanad,BEN_SI9,BEN_SI1,381727863,300247282,111026611,81480581,189220671,43893366,849233213,745820153,103413060,339499389,406320764,897358653,799698739,97659914,345341326,454357413
Wayanad,Wayanad,Wayanad-Wayanad,BEN_SI9,BEN_SI11,237538896,196793131,48332829,40745765,148460302,32792807,849233213,745820153,103413060,339499389,406320764,641166204,612648765,28517439,241001807,371646958
Wayanad,Wayanad,Wayanad-Wayanad,BEN_SI9,BEN_SI2,272127294,241968953,99305322,30158341,142663631,58712441,849233213,745820153,103413060,339499389,406320764,650993225,648515374,2477851,140667619,507847755
Wayanad,Wayanad,Wayanad-Wayanad,BEN_SI9,BEN_SI3,404037588,326691641,141742962,77345947,184948679,50531959,849233213,745820153,103413060,339499389,406320764,931565359,847325564,84239795,345974583,501350981
Wayanad,Wayanad,Wayanad-Wayanad,BEN_SI9,BEN_SI4,449321887,366234833,143937002,83087054,222297831,69441771,849233213,745820153,103413060,339499389,406320764,1109312253,1030580255,78731998,302255092,728325163
Wayanad,Wayanad,Wayanad-Wayanad,BEN_SI9,BEN_SI6,389236271,311770657,108689743,77465614,203080914,43306541,849233213,745820153,103413060,339499389,406320764,951080464,864453508,86626956,319674486,544779022
Wayanad,Wayanad,Wayanad-Wayanad,BEN_SI9,BEN_SI7,408452890,328651939,145062796,79800951,183589143,52858911,849233213,745820153,103413060,339499389,406320764,942430262,853584663,88845599,335397181,518187482
Wayanad,Wayanad,Wayanad-Wayanad,BEN_SI9,BEN_SI8,450118463,366331298,140553460,83787165,225777838,67011138,849233213,745820153,103413060,339499389,406320764,1108177315,1029030472,79146843,300308119,728722353
Wayanad,Zoo,Wayanad-Zoo,BEN_SI1,ZSB_01,309095422,246904582,93555808,62190840,153348774,24872355,897358653,799698739,97659914,345341326,454357413,723092447,635855373,87237074,256023333,379832040
Wayanad,Zoo,Wayanad-Zoo,BEN_SI1,ZSB_02,354782216,282658720,83936035,72123496,198722685,48130050,897358653,799698739,97659914,345341326,454357413,942790346,865053483,77736863,260820720,604232763
Wayanad,Zoo,Wayanad-Zoo,BEN_SI1,ZSB_03,340672122,272548972,70263767,68123150,202285205,21408570,897358653,799698739,97659914,345341326,454357413,892317758,827799945,64517813,241409256,586390689
Wayanad,Zoo,Wayanad-Zoo,BEN_SI1,ZSB_04,322246870,254490294,66299205,67756576,188191089,40093807,897358653,799698739,97659914,345341326,454357413,867386629,799476794,67909835,302302125,497174669
Wayanad,Zoo,Wayanad-Zoo,BEN_SI1,ZSB_05,369469192,302495150,126316456,66974042,176178694,44124137,897358653,799698739,97659914,345341326,454357413,864922054,784467789,80454265,246263826,538203963
Wayanad,Zoo,Wayanad-Zoo,BEN_SI11,ZSB_01,194879975,158832947,43574206,36047028,115258741,21063377,641166204,612648765,28517439,241001807,371646958,723092447,635855373,87237074,256023333,379832040
Wayanad,Zoo,Wayanad-Zoo,BEN_SI11,ZSB_02,240239079,203807073,67624707,36432006,136182366,41338295,641166204,612648765,28517439,241001807,371646958,942790346,865053483,77736863,260820720,604232763
Wayanad,Zoo,Wayanad-Zoo,BEN_SI11,ZSB_03,262793260,233450242,106855055,29343018,126595187,54895609,641166204,612648765,28517439,241001807,371646958,892317758,827799945,64517813,241409256,586390689
Wayanad,Zoo,Wayanad-Zoo,BEN_SI11,ZSB_04,247479682,216779934,72750928,30699748,144029006,36440877,641166204,612648765,28517439,241001807,371646958,867386629,799476794,67909835,302302125,497174669
Wayanad,Zoo,Wayanad-Zoo,BEN_SI11,ZSB_05,236985640,198553134,79886565,38432506,118666569,37420952,641166204,612648765,28517439,241001807,371646958,864922054,784467789,80454265,246263826,538203963
Wayanad,Zoo,Wayanad-Zoo,BEN_SI2,ZSB_01,207218747,182274861,84812020,24943886,97462841,29283921,650993225,648515374,2477851,140667619,507847755,723092447,635855373,87237074,256023333,379832040
Wayanad,Zoo,Wayanad-Zoo,BEN_SI2,ZSB_02,256663051,231883693,115238437,24779358,116645256,49583643,650993225,648515374,2477851,140667619,507847755,942790346,865053483,77736863,260820720,604232763
Wayanad,Zoo,Wayanad-Zoo,BEN_SI2,ZSB_03,271241109,250696218,130603089,20544891,120093129,44548605,650993225,648515374,2477851,140667619,507847755,892317758,827799945,64517813,241409256,586390689
Wayanad,Zoo,Wayanad-Zoo,BEN_SI2,ZSB_04,260283168,236555869,106428468,23727299,130127401,53838428,650993225,648515374,2477851,140667619,507847755,867386629,799476794,67909835,302302125,497174669
Wayanad,Zoo,Wayanad-Zoo,BEN_SI2,ZSB_05,257018329,231471443,115419756,25546886,116051687,31826443,650993225,648515374,2477851,140667619,507847755,864922054,784467789,80454265,246263826,538203963
Wayanad,Zoo,Wayanad-Zoo,BEN_SI3,ZSB_01,277971060,212591898,56438400,65379162,156153498,23057002,931565359,847325564,84239795,345974583,501350981,723092447,635855373,87237074,256023333,379832040
Wayanad,Zoo,Wayanad-Zoo,BEN_SI3,ZSB_02,378318587,313522126,119716247,64796461,193805879,59098643,931565359,847325564,84239795,345974583,501350981,942790346,865053483,77736863,260820720,604232763
Wayanad,Zoo,Wayanad-Zoo,BEN_SI3,ZSB_03,361814711,301484950,117835707,60329761,183649243,54511936,931565359,847325564,84239795,345974583,501350981,892317758,827799945,64517813,241409256,586390689
Wayanad,Zoo,Wayanad-Zoo,BEN_SI3,ZSB_04,334287919,271350720,68223064,62937199,203127656,48225601,931565359,847325564,84239795,345974583,501350981,867386629,799476794,67909835,302302125,497174669
Wayanad,Zoo,Wayanad-Zoo,BEN_SI3,ZSB_05,357050035,288210713,112220589,68839322,175990124,38180388,931565359,847325564,84239795,345974583,501350981,864922054,784467789,80454265,246263826,538203963
Wayanad,Zoo,Wayanad-Zoo,BEN_SI4,ZSB_01,313086524,240484791,61445237,72601733,179039554,19182674,1109312253,1030580255,78731998,302255092,728325163,723092447,635855373,87237074,256023333,379832040
Wayanad,Zoo,Wayanad-Zoo,BEN_SI4,ZSB_02,471550169,404523538,188580428,67026631,215943110,71739785,1109312253,1030580255,78731998,302255092,728325163,942790346,865053483,77736863,260820720,604232763
Wayanad,Zoo,Wayanad-Zoo,BEN_SI4,ZSB_03,418123674,357951148,148159802,60172526,209791346,60016902,1109312253,1030580255,78731998,302255092,728325163,892317758,827799945,64517813,241409256,586390689
Wayanad,Zoo,Wayanad-Zoo,BEN_SI4,ZSB_04,411209392,349176348,139033597,62033044,210142751,73941223,1109312253,1030580255,78731998,302255092,728325163,867386629,799476794,67909835,302302125,497174669
Wayanad,Zoo,Wayanad-Zoo,BEN_SI4,ZSB_05,440781851,372661705,180171280,68120146,192490425,71718472,1109312253,1030580255,78731998,302255092,728325163,864922054,784467789,80454265,246263826,538203963
Wayanad,Zoo,Wayanad-Zoo,BEN_SI6,ZSB_01,307238833,244411245,92842579,62827588,151568666,42695266,951080464,864453508,86626956,319674486,544779022,723092447,635855373,87237074,256023333,379832040
Wayanad,Zoo,Wayanad-Zoo,BEN_SI6,ZSB_02,396645943,329303337,134735442,67342606,194567895,60008335,951080464,864453508,86626956,319674486,544779022,942790346,865053483,77736863,260820720,604232763
Wayanad,Zoo,Wayanad-Zoo,BEN_SI6,ZSB_03,380401097,317255316,135744919,63145781,181510397,64886711,951080464,864453508,86626956,319674486,544779022,892317758,827799945,64517813,241409256,586390689
Wayanad,Zoo,Wayanad-Zoo,BEN_SI6,ZSB_04,344585788,278810705,101201318,65775083,177609387,72743962,951080464,864453508,86626956,319674486,544779022,867386629,799476794,67909835,302302125,497174669
Wayanad,Zoo,Wayanad-Zoo,BEN_SI6,ZSB_05,369334857,302141698,129575214,67193159,172566484,50010132,951080464,864453508,86626956,319674486,544779022,864922054,784467789,80454265,246263826,538203963
Wayanad,Zoo,Wayanad-Zoo,BEN_SI7,ZSB_01,281560930,214217833,60947049,67343097,153270784,22757145,942430262,853584663,88845599,335397181,518187482,723092447,635855373,87237074,256023333,379832040
Wayanad,Zoo,Wayanad-Zoo,BEN_SI7,ZSB_02,384677900,317344545,123364722,67333355,193979823,57194387,942430262,853584663,88845599,335397181,518187482,942790346,865053483,77736863,260820720,604232763
Wayanad,Zoo,Wayanad-Zoo,BEN_SI7,ZSB_03,366752267,304488473,120650836,62263794,183837637,53640875,942430262,853584663,88845599,335397181,518187482,892317758,827799945,64517813,241409256,586390689
Wayanad,Zoo,Wayanad-Zoo,BEN_SI7,ZSB_04,339826232,274342685,64516224,65483547,209826461,48011188,942430262,853584663,88845599,335397181,518187482,867386629,799476794,67909835,302302125,497174669
Wayanad,Zoo,Wayanad-Zoo,BEN_SI7,ZSB_05,361766461,290274232,115256966,71492229,175017266,42022936,942430262,853584663,88845599,335397181,518187482,864922054,784467789,80454265,246263826,538203963
Wayanad,Zoo,Wayanad-Zoo,BEN_SI8,ZSB_01,312093577,238052189,61154892,74041388,176897297,22620046,1108177315,1029030472,79146843,300308119,728722353,723092447,635855373,87237074,256023333,379832040
Wayanad,Zoo,Wayanad-Zoo,BEN_SI8,ZSB_02,471244912,404402213,187605942,66842699,216796271,72651621,1108177315,1029030472,79146843,300308119,728722353,942790346,865053483,77736863,260820720,604232763
Wayanad,Zoo,Wayanad-Zoo,BEN_SI8,ZSB_03,417132665,356343522,144783094,60789143,211560428,56132016,1108177315,1029030472,79146843,300308119,728722353,892317758,827799945,64517813,241409256,586390689
Wayanad,Zoo,Wayanad-Zoo,BEN_SI8,ZSB_04,410415005,348516290,136444605,61898715,212071685,73306026,1108177315,1029030472,79146843,300308119,728722353,867386629,799476794,67909835,302302125,497174669
Wayanad,Zoo,Wayanad-Zoo,BEN_SI8,ZSB_05,439891282,373266913,179325299,66624369,193941614,67292306,1108177315,1029030472,79146843,300308119,728722353,864922054,784467789,80454265,246263826,538203963
Wayanad,Zoo,Wayanad-Zoo,BEN_SI9,ZSB_01,287435251,221744566,75423679,65690685,146320887,27144241,849233213,745820153,103413060,339499389,406320764,723092447,635855373,87237074,256023333,379832040
Wayanad,Zoo,Wayanad-Zoo,BEN_SI9,ZSB_02,351407523,281523562,95230127,69883961,186293435,54994992,849233213,745820153,103413060,339499389,406320764,942790346,865053483,77736863,260820720,604232763
Wayanad,Zoo,Wayanad-Zoo,BEN_SI9,ZSB_03,339748088,274054472,91181294,65693616,182873178,45968217,849233213,745820153,103413060,339499389,406320764,892317758,827799945,64517813,241409256,586390689
Wayanad,Zoo,Wayanad-Zoo,BEN_SI9,ZSB_04,319610297,253018646,65843305,66591651,187175341,42695887,849233213,745820153,103413060,339499389,406320764,867386629,799476794,67909835,302302125,497174669
Wayanad,Zoo,Wayanad-Zoo,BEN_SI9,ZSB_05,332641972,263881298,89856302,68760674,174024996,35436507,849233213,745820153,103413060,339499389,406320764,864922054,784467789,80454265,246263826,538203963
Zoo,Chandrapur,Zoo-Chandrapur,ZSB_01,BEN_CI2,215232920,182719340,59014040,32513580,123705300,15467613,723092447,635855373,87237074,256023333,379832040,674364895,657438378,16926517,229909737,427528641
Zoo,Chandrapur,Zoo-Chandrapur,ZSB_02,BEN_CI2,270557417,240206075,94331191,30351342,145874884,46951088,942790346,865053483,77736863,260820720,604232763,674364895,657438378,16926517,229909737,427528641
Zoo,Chandrapur,Zoo-Chandrapur,ZSB_03,BEN_CI2,253794762,226280116,80857650,27514646,145422466,35392584,892317758,827799945,64517813,241409256,586390689,674364895,657438378,16926517,229909737,427528641
Zoo,Chandrapur,Zoo-Chandrapur,ZSB_04,BEN_CI2,270297133,244184953,89999567,26112180,154185386,41042907,867386629,799476794,67909835,302302125,497174669,674364895,657438378,16926517,229909737,427528641
Zoo,Chandrapur,Zoo-Chandrapur,ZSB_05,BEN_CI2,264954750,234046765,99909746,30907985,134137019,52098953,864922054,784467789,80454265,246263826,538203963,674364895,657438378,16926517,229909737,427528641
Zoo,Corbett,Zoo-Corbett,ZSB_01,BEN_NOR1,230617595,171650420,39057173,58967175,132593247,28432532,723092447,635855373,87237074,256023333,379832040,689133358,592060124,97073234,396388890,195671234
Zoo,Corbett,Zoo-Corbett,ZSB_01,BEN_NOR2,281841319,217336276,69632501,64505043,147703775,26267879,723092447,635855373,87237074,256023333,379832040,872604239,770086648,102517591,315997124,454089524
Zoo,Corbett,Zoo-Corbett,ZSB_02,BEN_NOR1,302492641,239466456,43616013,63026185,195850443,34413613,942790346,865053483,77736863,260820720,604232763,689133358,592060124,97073234,396388890,195671234
Zoo,Corbett,Zoo-Corbett,ZSB_02,BEN_NOR2,354798342,279593678,105942709,75204664,173650969,51185935,942790346,865053483,77736863,260820720,604232763,872604239,770086648,102517591,315997124,454089524
Zoo,Corbett,Zoo-Corbett,ZSB_03,BEN_NOR1,270300556,210594057,43260142,59706499,167333915,27583625,892317758,827799945,64517813,241409256,586390689,689133358,592060124,97073234,396388890,195671234
Zoo,Corbett,Zoo-Corbett,ZSB_03,BEN_NOR2,337893686,271829676,99046942,66064010,172782734,42468058,892317758,827799945,64517813,241409256,586390689,872604239,770086648,102517591,315997124,454089524
Zoo,Corbett,Zoo-Corbett,ZSB_04,BEN_NOR1,258921093,200260995,27913326,58660098,172347669,19099951,867386629,799476794,67909835,302302125,497174669,689133358,592060124,97073234,396388890,195671234
Zoo,Corbett,Zoo-Corbett,ZSB_04,BEN_NOR2,311629266,243724128,72794682,67905138,170929446,42134549,867386629,799476794,67909835,302302125,497174669,872604239,770086648,102517591,315997124,454089524
Zoo,Corbett,Zoo-Corbett,ZSB_05,BEN_NOR1,269024898,202832308,38343431,66192590,164488877,29262458,864922054,784467789,80454265,246263826,538203963,689133358,592060124,97073234,396388890,195671234
Zoo,Corbett,Zoo-Corbett,ZSB_05,BEN_NOR2,352948457,281779011,120852277,71169446,160926734,38020690,864922054,784467789,80454265,246263826,538203963,872604239,770086648,102517591,315997124,454089524
Zoo,Kanha,Zoo-Kanha,ZSB_01,BEN_CI15,178259380,118724130,10388573,59535250,108335557,10388573,723092447,635855373,87237074,256023333,379832040,558426844,440368350,118058494,313676252,126692098
Zoo,Kanha,Zoo-Kanha,ZSB_01,BEN_CI16,317473553,259347801,119075230,58125752,140272571,30396776,723092447,635855373,87237074,256023333,379832040,941465693,865515372,75950321,260165870,605349502
Zoo,Kanha,Zoo-Kanha,ZSB_01,BEN_CI18,162499566,105289099,8947299,57210467,96341800,5556673,723092447,635855373,87237074,256023333,379832040,531335982,416398696,114937286,280261230,136137466
Zoo,Kanha,Zoo-Kanha,ZSB_01,BEN_CI19,106133545,58124155,2640990,48009390,55483165,2640990,723092447,635855373,87237074,256023333,379832040,370653731,261143653,109510078,241812071,19331582
Zoo,Kanha,Zoo-Kanha,ZSB_01,BEN_CI3,210273002,154552458,46900963,55720544,107651495,16902056,723092447,635855373,87237074,256023333,379832040,399948004,398407865,1540139,114426239,283981626
Zoo,Kanha,Zoo-Kanha,ZSB_01,BEN_CI4,189478474,141140514,37893313,48337960,103247201,12914686,723092447,635855373,87237074,256023333,379832040,588039664,506748544,81291120,270707157,236041387
Zoo,Kanha,Zoo-Kanha,ZSB_01,BEN_CI5,143448708,96424684,8903679,47024024,87521005,4308282,723092447,635855373,87237074,256023333,379832040,447217937,358814659,88403278,289122614,69692045
Zoo,Kanha,Zoo-Kanha,ZSB_01,BEN_CI6,181156252,127359035,22830377,53797217,104528658,15382215,723092447,635855373,87237074,256023333,379832040,558093435,456569955,101523480,304633087,151936868
Zoo,Kanha,Zoo-Kanha,ZSB_01,BEN_CI7,221015387,189932290,75386770,31083097,114545520,25373656,723092447,635855373,87237074,256023333,379832040,746271387,730520258,15751129,197580294,532939964
Zoo,Kanha,Zoo-Kanha,ZSB_02,BEN_CI15,235306407,169643063,29198713,65663344,140444350,14730630,942790346,865053483,77736863,260820720,604232763,558426844,440368350,118058494,313676252,126692098
Zoo,Kanha,Zoo-Kanha,ZSB_02,BEN_CI16,417351945,357470076,165762753,59881869,191707323,56897912,942790346,865053483,77736863,260820720,604232763,941465693,865515372,75950321,260165870,605349502
Zoo,Kanha,Zoo-Kanha,ZSB_02,BEN_CI18,218073965,154226281,25419690,63847684,128806591,23290778,942790346,865053483,77736863,260820720,604232763,531335982,416398696,114937286,280261230,136137466
Zoo,Kanha,Zoo-Kanha,ZSB_02,BEN_CI19,153395185,96333014,1177170,57062171,95155844,1177170,942790346,865053483,77736863,260820720,604232763,370653731,261143653,109510078,241812071,19331582
Zoo,Kanha,Zoo-Kanha,ZSB_02,BEN_CI3,281154217,219392116,73656256,61762101,145735860,31828112,942790346,865053483,77736863,260820720,604232763,399948004,398407865,1540139,114426239,283981626
Zoo,Kanha,Zoo-Kanha,ZSB_02,BEN_CI4,261013950,212143625,69532843,48870325,142610782,32015581,942790346,865053483,77736863,260820720,604232763,588039664,506748544,81291120,270707157,236041387
Zoo,Kanha,Zoo-Kanha,ZSB_02,BEN_CI5,197522060,148927064,23238881,48594996,125688183,16331259,942790346,865053483,77736863,260820720,604232763,447217937,358814659,88403278,289122614,69692045
Zoo,Kanha,Zoo-Kanha,ZSB_02,BEN_CI6,247444461,188992147,38093850,58452314,150898297,30339822,942790346,865053483,77736863,260820720,604232763,558093435,456569955,101523480,304633087,151936868
Zoo,Kanha,Zoo-Kanha,ZSB_02,BEN_CI7,343595459,315907838,192997050,27687621,122910788,56646022,942790346,865053483,77736863,260820720,604232763,746271387,730520258,15751129,197580294,532939964
Zoo,Kanha,Zoo-Kanha,ZSB_03,BEN_CI15,219727367,158436339,21075502,61291028,137360837,9911599,892317758,827799945,64517813,241409256,586390689,558426844,440368350,118058494,313676252,126692098
Zoo,Kanha,Zoo-Kanha,ZSB_03,BEN_CI16,408974496,357207366,174308062,51767130,182899304,56016363,892317758,827799945,64517813,241409256,586390689,941465693,865515372,75950321,260165870,605349502
Zoo,Kanha,Zoo-Kanha,ZSB_03,BEN_CI18,214002385,156235137,42198011,57767248,114037126,16719026,892317758,827799945,64517813,241409256,586390689,531335982,416398696,114937286,280261230,136137466
Zoo,Kanha,Zoo-Kanha,ZSB_03,BEN_CI19,148223551,93076699,6555064,55146852,86521635,6555064,892317758,827799945,64517813,241409256,586390689,370653731,261143653,109510078,241812071,19331582
Zoo,Kanha,Zoo-Kanha,ZSB_03,BEN_CI3,257620865,196615933,65995175,61004932,130620758,32868672,892317758,827799945,64517813,241409256,586390689,399948004,398407865,1540139,114426239,283981626
Zoo,Kanha,Zoo-Kanha,ZSB_03,BEN_CI4,247597808,201147378,81452151,46450430,119695227,20945051,892317758,827799945,64517813,241409256,586390689,588039664,506748544,81291120,270707157,236041387
Zoo,Kanha,Zoo-Kanha,ZSB_03,BEN_CI5,184627971,136439578,14538325,48188393,121901253,12257606,892317758,827799945,64517813,241409256,586390689,447217937,358814659,88403278,289122614,69692045
Zoo,Kanha,Zoo-Kanha,ZSB_03,BEN_CI6,226536379,170279260,42431723,56257119,127847537,28876240,892317758,827799945,64517813,241409256,586390689,558093435,456569955,101523480,304633087,151936868
Zoo,Kanha,Zoo-Kanha,ZSB_03,BEN_CI7,304551985,281851185,143694665,22700800,138156520,43417293,892317758,827799945,64517813,241409256,586390689,746271387,730520258,15751129,197580294,532939964
Zoo,Kanha,Zoo-Kanha,ZSB_04,BEN_CI15,231490101,171595076,38679516,59895025,132915560,21483298,867386629,799476794,67909835,302302125,497174669,558426844,440368350,118058494,313676252,126692098
Zoo,Kanha,Zoo-Kanha,ZSB_04,BEN_CI16,388310597,337009435,151738457,51301162,185270978,59996425,867386629,799476794,67909835,302302125,497174669,941465693,865515372,75950321,260165870,605349502
Zoo,Kanha,Zoo-Kanha,ZSB_04,BEN_CI18,207592228,149476769,24745354,58115459,124731415,12203947,867386629,799476794,67909835,302302125,497174669,531335982,416398696,114937286,280261230,136137466
Zoo,Kanha,Zoo-Kanha,ZSB_04,BEN_CI19,141528682,90233359,2261740,51295323,87971619,2261740,867386629,799476794,67909835,302302125,497174669,370653731,261143653,109510078,241812071,19331582
Zoo,Kanha,Zoo-Kanha,ZSB_04,BEN_CI3,256312738,198234010,48729085,58078728,149504925,23358767,867386629,799476794,67909835,302302125,497174669,399948004,398407865,1540139,114426239,283981626
Zoo,Kanha,Zoo-Kanha,ZSB_04,BEN_CI4,242828624,197060936,70296270,45767688,126764666,36690835,867386629,799476794,67909835,302302125,497174669,588039664,506748544,81291120,270707157,236041387
Zoo,Kanha,Zoo-Kanha,ZSB_04,BEN_CI5,169902001,124359230,11581395,45542771,112777835,11581395,867386629,799476794,67909835,302302125,497174669,447217937,358814659,88403278,289122614,69692045
Zoo,Kanha,Zoo-Kanha,ZSB_04,BEN_CI6,232107788,180415154,51437203,51692634,128977951,36020861,867386629,799476794,67909835,302302125,497174669,558093435,456569955,101523480,304633087,151936868
Zoo,Kanha,Zoo-Kanha,ZSB_04,BEN_CI7,314995178,290405990,141887052,24589188,148518938,62790139,867386629,799476794,67909835,302302125,497174669,746271387,730520258,15751129,197580294,532939964
Zoo,Kanha,Zoo-Kanha,ZSB_05,BEN_CI15,224746977,158616390,40051778,66130587,118564612,17914944,864922054,784467789,80454265,246263826,538203963,558426844,440368350,118058494,313676252,126692098
Zoo,Kanha,Zoo-Kanha,ZSB_05,BEN_CI16,339237787,272095084,97423627,67142703,174671457,32589825,864922054,784467789,80454265,246263826,538203963,941465693,865515372,75950321,260165870,605349502
Zoo,Kanha,Zoo-Kanha,ZSB_05,BEN_CI18,207908005,144281303,25874282,63626702,118407021,23387982,864922054,784467789,80454265,246263826,538203963,531335982,416398696,114937286,280261230,136137466
Zoo,Kanha,Zoo-Kanha,ZSB_05,BEN_CI19,157259624,99421446,5134902,57838178,94286544,5134902,864922054,784467789,80454265,246263826,538203963,370653731,261143653,109510078,241812071,19331582
Zoo,Kanha,Zoo-Kanha,ZSB_05,BEN_CI3,237786534,171401441,38500636,66385093,132900805,27175792,864922054,784467789,80454265,246263826,538203963,399948004,398407865,1540139,114426239,283981626
Zoo,Kanha,Zoo-Kanha,ZSB_05,BEN_CI4,224109158,174330005,53711334,49779153,120618671,20098627,864922054,784467789,80454265,246263826,538203963,588039664,506748544,81291120,270707157,236041387
Zoo,Kanha,Zoo-Kanha,ZSB_05,BEN_CI5,175555624,124654181,15557741,50901443,109096440,10714001,864922054,784467789,80454265,246263826,538203963,447217937,358814659,88403278,289122614,69692045
Zoo,Kanha,Zoo-Kanha,ZSB_05,BEN_CI6,219781888,159641159,33344186,60140729,126296973,19148851,864922054,784467789,80454265,246263826,538203963,558093435,456569955,101523480,304633087,151936868
Zoo,Kanha,Zoo-Kanha,ZSB_05,BEN_CI7,251540783,219699068,83595603,31841715,136103465,22798024,864922054,784467789,80454265,246263826,538203963,746271387,730520258,15751129,197580294,532939964
Zoo,Kaziranga,Zoo-Kaziranga,ZSB_01,BEN_NE1,177962119,115620362,15746024,62341757,99874338,10115018,723092447,635855373,87237074,256023333,379832040,560246780,423100976,137145804,256700947,166400029
Zoo,Kaziranga,Zoo-Kaziranga,ZSB_01,BEN_NE2,364799917,287568618,94488789,77231299,193079829,42580795,723092447,635855373,87237074,256023333,379832040,1250511108,1174630426,75880682,233913209,940717217
Zoo,Kaziranga,Zoo-Kaziranga,ZSB_01,BEN_NE3,331920232,268610328,103646769,63309904,164963559,41137884,723092447,635855373,87237074,256023333,379832040,1008859852,937520336,71339516,277485474,660034862
Zoo,Kaziranga,Zoo-Kaziranga,ZSB_02,BEN_NE1,256932088,185850957,61349773,71081131,124501184,28221563,942790346,865053483,77736863,260820720,604232763,560246780,423100976,137145804,256700947,166400029
Zoo,Kaziranga,Zoo-Kaziranga,ZSB_02,BEN_NE2,497771873,421676706,208603007,76095167,213073699,93180742,942790346,865053483,77736863,260820720,604232763,1250511108,1174630426,75880682,233913209,940717217
Zoo,Kaziranga,Zoo-Kaziranga,ZSB_02,BEN_NE3,404474843,336323102,155603737,68151741,180719365,54565491,942790346,865053483,77736863,260820720,604232763,1008859852,937520336,71339516,277485474,660034862
Zoo,Kaziranga,Zoo-Kaziranga,ZSB_03,BEN_NE1,238313600,172507706,50376612,65805894,122131094,15693086,892317758,827799945,64517813,241409256,586390689,560246780,423100976,137145804,256700947,166400029
Zoo,Kaziranga,Zoo-Kaziranga,ZSB_03,BEN_NE2,477666491,410755707,209124687,66910784,201631020,90772742,892317758,827799945,64517813,241409256,586390689,1250511108,1174630426,75880682,233913209,940717217
Zoo,Kaziranga,Zoo-Kaziranga,ZSB_03,BEN_NE3,418963561,358482394,176530452,60481167,181951942,67413056,892317758,827799945,64517813,241409256,586390689,1008859852,937520336,71339516,277485474,660034862
Zoo,Kaziranga,Zoo-Kaziranga,ZSB_04,BEN_NE1,225364490,160484919,34430708,64879571,126054211,14144084,867386629,799476794,67909835,302302125,497174669,560246780,423100976,137145804,256700947,166400029
Zoo,Kaziranga,Zoo-Kaziranga,ZSB_04,BEN_NE2,468753030,402885743,179523241,65867287,223362502,87658298,867386629,799476794,67909835,302302125,497174669,1250511108,1174630426,75880682,233913209,940717217
Zoo,Kaziranga,Zoo-Kaziranga,ZSB_04,BEN_NE3,378578337,317202906,127006137,61375431,190196769,61196786,867386629,799476794,67909835,302302125,497174669,1008859852,937520336,71339516,277485474,660034862
Zoo,Kaziranga,Zoo-Kaziranga,ZSB_05,BEN_NE1,214707605,145293908,30603600,69413697,114690308,9663401,864922054,784467789,80454265,246263826,538203963,560246780,423100976,137145804,256700947,166400029
Zoo,Kaziranga,Zoo-Kaziranga,ZSB_05,BEN_NE2,452805499,374577856,181022184,78227643,193555672,62831812,864922054,784467789,80454265,246263826,538203963,1250511108,1174630426,75880682,233913209,940717217
Zoo,Kaziranga,Zoo-Kaziranga,ZSB_05,BEN_NE3,384656823,318709167,153422440,65947656,165286727,51763701,864922054,784467789,80454265,246263826,538203963,1008859852,937520336,71339516,277485474,660034862
Zoo,Lalgarh,Zoo-Lalgarh,ZSB_01,LGS1,247261897,183945363,43973601,63316534,139971762,25247778,723092447,635855373,87237074,256023333,379832040,737843728,638009894,99833834,404772144,233237750
Zoo,Lalgarh,Zoo-Lalgarh,ZSB_02,LGS1,321148231,253580883,77043523,67567348,176537360,46025622,942790346,865053483,77736863,260820720,604232763,737843728,638009894,99833834,404772144,233237750
Zoo,Lalgarh,Zoo-Lalgarh,ZSB_03,LGS1,307975647,244304664,71717419,63670983,172587245,38971003,892317758,827799945,64517813,241409256,586390689,737843728,638009894,99833834,404772144,233237750
Zoo,Lalgarh,Zoo-Lalgarh,ZSB_04,LGS1,301129209,240976160,70069811,60153049,170906349,41281496,867386629,799476794,67909835,302302125,497174669,737843728,638009894,99833834,404772144,233237750
Zoo,Lalgarh,Zoo-Lalgarh,ZSB_05,LGS1,299134961,232636956,61169155,66498005,171467801,29592717,864922054,784467789,80454265,246263826,538203963,737843728,638009894,99833834,404772144,233237750
Zoo,Periyar,Zoo-Periyar,ZSB_01,BEN_SI5,430003569,360923942,149074456,69079627,211849486,66448841,723092447,635855373,87237074,256023333,379832040,1343835283,1299687777,44147506,344660143,955027634
Zoo,Periyar,Zoo-Periyar,ZSB_02,BEN_SI5,527453156,461075273,202962181,66377883,258113092,110374954,942790346,865053483,77736863,260820720,604232763,1343835283,1299687777,44147506,344660143,955027634
Zoo,Periyar,Zoo-Periyar,ZSB_03,BEN_SI5,522011107,465245085,236667779,56766022,228577306,117855100,892317758,827799945,64517813,241409256,586390689,1343835283,1299687777,44147506,344660143,955027634
Zoo,Periyar,Zoo-Periyar,ZSB_04,BEN_SI5,510766056,452665972,199582366,58100084,253083606,115192223,867386629,799476794,67909835,302302125,497174669,1343835283,1299687777,44147506,344660143,955027634
Zoo,Periyar,Zoo-Periyar,ZSB_05,BEN_SI5,511291845,442551679,208986330,68740166,233565349,89172281,864922054,784467789,80454265,246263826,538203963,1343835283,1299687777,44147506,344660143,955027634
Zoo,Ranthambore,Zoo-Ranthambore,ZSB_01,BEN_NW10,412244260,348095127,147670784,64149133,200424343,66109362,723092447,635855373,87237074,256023333,379832040,1266198710,1229664069,36534641,328923565,900740504
Zoo,Ranthambore,Zoo-Ranthambore,ZSB_01,BEN_NW11,335241250,282454267,134209280,52786983,148244987,49893780,723092447,635855373,87237074,256023333,379832040,997123987,950413379,46710608,263905963,686507416
Zoo,Ranthambore,Zoo-Ranthambore,ZSB_01,BEN_NW12,424432197,362263863,184952064,62168334,177311799,62673224,723092447,635855373,87237074,256023333,379832040,1267506856,1231795407,35711449,227052846,1004742561
Zoo,Ranthambore,Zoo-Ranthambore,ZSB_01,BEN_NW13,397413811,338713492,149365805,58700319,189347687,60131539,723092447,635855373,87237074,256023333,379832040,1183131254,1138285233,44846021,344174628,794110605
Zoo,Ranthambore,Zoo-Ranthambore,ZSB_01,BEN_NW14,382537880,320107484,162071369,62430396,158036115,44712774,723092447,635855373,87237074,256023333,379832040,1235716540,1190952996,44763544,177541519,1013411477
Zoo,Ranthambore,Zoo-Ranthambore,ZSB_01,BEN_NW17,337206481,280887245,113686341,56319236,167200904,58768892,723092447,635855373,87237074,256023333,379832040,1116321554,1085802823,30518731,256140006,829662817
Zoo,Ranthambore,Zoo-Ranthambore,ZSB_01,BEN_NW18,436279296,373297857,163538187,62981439,209759670,68860238,723092447,635855373,87237074,256023333,379832040,1339364699,1300736006,38628693,242877521,1057858485
Zoo,Ranthambore,Zoo-Ranthambore,ZSB_01,BEN_NW19,356382052,300037815,151347433,56344237,148690382,42942270,723092447,635855373,87237074,256023333,379832040,1081768306,1036331080,45437226,232322355,804008725
Zoo,Ranthambore,Zoo-Ranthambore,ZSB_01,BEN_NW20,365416013,298528690,97315101,66887323,201213589,58501027,723092447,635855373,87237074,256023333,379832040,1086271749,1022278981,63992768,541693814,480585167
Zoo,Ranthambore,Zoo-Ranthambore,ZSB_01,BEN_NW24,386924482,324352505,145813748,62571977,178538757,56621506,723092447,635855373,87237074,256023333,379832040,1159641386,1113494396,46146990,301627698,811866698
Zoo,Ranthambore,Zoo-Ranthambore,ZSB_01,BEN_NW3,425390615,366699595,192877457,58691020,173822138,47336267,723092447,635855373,87237074,256023333,379832040,1280728709,1240123254,40605455,207797688,1032325566
Zoo,Ranthambore,Zoo-Ranthambore,ZSB_01,BEN_NW4,388017565,330558486,164931058,57459079,165627428,38584498,723092447,635855373,87237074,256023333,379832040,1219365724,1186222475,33143249,158691252,1027531223
Zoo,Ranthambore,Zoo-Ranthambore,ZSB_01,BEN_NW5,326432287,271292635,129638355,55139652,141654280,31570016,723092447,635855373,87237074,256023333,379832040,977809134,918585062,59224072,241966240,676618822
Zoo,Ranthambore,Zoo-Ranthambore,ZSB_01,BEN_NW55,374635296,311488040,100537624,63147256,210950416,66392550,723092447,635855373,87237074,256023333,379832040,1131174741,1073214798,57959943,534097691,539117107
Zoo,Ranthambore,Zoo-Ranthambore,ZSB_01,BEN_NW57,375002296,300422962,64056860,74579334,236366102,33372679,723092447,635855373,87237074,256023333,379832040,1180288036,1103120235,77167801,638361097,464759138
Zoo,Ranthambore,Zoo-Ranthambore,ZSB_01,BEN_NW6,319368860,265656463,108677228,53712397,156979235,43485953,723092447,635855373,87237074,256023333,379832040,992143483,946435718,45707765,248527765,697907953
Zoo,Ranthambore,Zoo-Ranthambore,ZSB_01,BEN_NW8,357137982,295566885,111975740,61571097,183591145,50775381,723092447,635855373,87237074,256023333,379832040,1196839698,1156984240,39855458,275076038,881908202
Zoo,Ranthambore,Zoo-Ranthambore,ZSB_01,BEN_NW9,411178072,349998917,171277766,61179155,178721151,59097541,723092447,635855373,87237074,256023333,379832040,1246521228,1203200533,43320695,216389572,986810961
Zoo,Ranthambore,Zoo-Ranthambore,ZSB_02,BEN_NW10,558525659,502757246,271108411,55768413,231648835,134151548,942790346,865053483,77736863,260820720,604232763,1266198710,1229664069,36534641,328923565,900740504
Zoo,Ranthambore,Zoo-Ranthambore,ZSB_02,BEN_NW11,474025532,426755316,238683116,47270216,188072200,103642038,942790346,865053483,77736863,260820720,604232763,997123987,950413379,46710608,263905963,686507416
Zoo,Ranthambore,Zoo-Ranthambore,ZSB_02,BEN_NW12,544639745,489674580,280218647,54965165,209455933,100162190,942790346,865053483,77736863,260820720,604232763,1267506856,1231795407,35711449,227052846,1004742561
Zoo,Ranthambore,Zoo-Ranthambore,ZSB_02,BEN_NW13,520040693,460791241,236081886,59249452,224709355,121985722,942790346,865053483,77736863,260820720,604232763,1183131254,1138285233,44846021,344174628,794110605
Zoo,Ranthambore,Zoo-Ranthambore,ZSB_02,BEN_NW14,549764487,492730326,289991680,57034161,202738646,105253413,942790346,865053483,77736863,260820720,604232763,1235716540,1190952996,44763544,177541519,1013411477
Zoo,Ranthambore,Zoo-Ranthambore,ZSB_02,BEN_NW17,494741566,446327947,236382097,48413619,209945850,97142086,942790346,865053483,77736863,260820720,604232763,1116321554,1085802823,30518731,256140006,829662817
Zoo,Ranthambore,Zoo-Ranthambore,ZSB_02,BEN_NW18,574346620,516122579,292297376,58224041,223825203,124077234,942790346,865053483,77736863,260820720,604232763,1339364699,1300736006,38628693,242877521,1057858485
Zoo,Ranthambore,Zoo-Ranthambore,ZSB_02,BEN_NW19,473740509,417290553,230418160,56449956,186872393,82586033,942790346,865053483,77736863,260820720,604232763,1081768306,1036331080,45437226,232322355,804008725
Zoo,Ranthambore,Zoo-Ranthambore,ZSB_02,BEN_NW20,469646342,404273903,134857723,65372439,269416180,86332551,942790346,865053483,77736863,260820720,604232763,1086271749,1022278981,63992768,541693814,480585167
Zoo,Ranthambore,Zoo-Ranthambore,ZSB_02,BEN_NW24,516154589,457668610,239085841,58485979,218582769,114869220,942790346,865053483,77736863,260820720,604232763,1159641386,1113494396,46146990,301627698,811866698
Zoo,Ranthambore,Zoo-Ranthambore,ZSB_02,BEN_NW3,535181410,475258285,274310194,59923125,200948091,84414087,942790346,865053483,77736863,260820720,604232763,1280728709,1240123254,40605455,207797688,1032325566
Zoo,Ranthambore,Zoo-Ranthambore,ZSB_02,BEN_NW4,535968044,484061694,298274599,51906350,185787095,105362138,942790346,865053483,77736863,260820720,604232763,1219365724,1186222475,33143249,158691252,1027531223
Zoo,Ranthambore,Zoo-Ranthambore,ZSB_02,BEN_NW5,436244183,382621198,209969514,53622985,172651684,56258393,942790346,865053483,77736863,260820720,604232763,977809134,918585062,59224072,241966240,676618822
Zoo,Ranthambore,Zoo-Ranthambore,ZSB_02,BEN_NW55,505262700,440187289,170235347,65075411,269951942,116314156,942790346,865053483,77736863,260820720,604232763,1131174741,1073214798,57959943,534097691,539117107
Zoo,Ranthambore,Zoo-Ranthambore,ZSB_02,BEN_NW57,507127228,430031883,131362313,77095345,298669570,95385298,942790346,865053483,77736863,260820720,604232763,1180288036,1103120235,77167801,638361097,464759138
Zoo,Ranthambore,Zoo-Ranthambore,ZSB_02,BEN_NW6,434442644,380073216,184770611,54369428,195302605,81775974,942790346,865053483,77736863,260820720,604232763,992143483,946435718,45707765,248527765,697907953
Zoo,Ranthambore,Zoo-Ranthambore,ZSB_02,BEN_NW8,504575061,445528176,230098626,59046885,215429550,105648431,942790346,865053483,77736863,260820720,604232763,1196839698,1156984240,39855458,275076038,881908202
Zoo,Ranthambore,Zoo-Ranthambore,ZSB_02,BEN_NW9,542775146,483293600,270106488,59481546,213187112,97032995,942790346,865053483,77736863,260820720,604232763,1246521228,1203200533,43320695,216389572,986810961
Zoo,Ranthambore,Zoo-Ranthambore,ZSB_03,BEN_NW10,521577343,469560150,238744359,52017193,230815791,118589100,892317758,827799945,64517813,241409256,586390689,1266198710,1229664069,36534641,328923565,900740504
Zoo,Ranthambore,Zoo-Ranthambore,ZSB_03,BEN_NW11,411299396,365904998,203437588,45394398,162467410,76894977,892317758,827799945,64517813,241409256,586390689,997123987,950413379,46710608,263905963,686507416
Zoo,Ranthambore,Zoo-Ranthambore,ZSB_03,BEN_NW12,479314741,426932204,223648745,52382537,203283459,82159637,892317758,827799945,64517813,241409256,586390689,1267506856,1231795407,35711449,227052846,1004742561
Zoo,Ranthambore,Zoo-Ranthambore,ZSB_03,BEN_NW13,467298624,415114947,183659520,52183677,231455427,102291318,892317758,827799945,64517813,241409256,586390689,1183131254,1138285233,44846021,344174628,794110605
Zoo,Ranthambore,Zoo-Ranthambore,ZSB_03,BEN_NW14,503381127,453218094,266261159,50163033,186956935,80293008,892317758,827799945,64517813,241409256,586390689,1235716540,1190952996,44763544,177541519,1013411477
Zoo,Ranthambore,Zoo-Ranthambore,ZSB_03,BEN_NW17,470186606,426369192,229456352,43817414,196912840,92177150,892317758,827799945,64517813,241409256,586390689,1116321554,1085802823,30518731,256140006,829662817
Zoo,Ranthambore,Zoo-Ranthambore,ZSB_03,BEN_NW18,521442220,468153025,255119414,53289195,213033611,96985763,892317758,827799945,64517813,241409256,586390689,1339364699,1300736006,38628693,242877521,1057858485
Zoo,Ranthambore,Zoo-Ranthambore,ZSB_03,BEN_NW19,425749306,375212976,205378522,50536330,169834454,65874521,892317758,827799945,64517813,241409256,586390689,1081768306,1036331080,45437226,232322355,804008725
Zoo,Ranthambore,Zoo-Ranthambore,ZSB_03,BEN_NW20,442484584,383272493,121784016,59212091,261488477,82517237,892317758,827799945,64517813,241409256,586390689,1086271749,1022278981,63992768,541693814,480585167
Zoo,Ranthambore,Zoo-Ranthambore,ZSB_03,BEN_NW24,469774625,416526005,195521486,53248620,221004519,77449703,892317758,827799945,64517813,241409256,586390689,1159641386,1113494396,46146990,301627698,811866698
Zoo,Ranthambore,Zoo-Ranthambore,ZSB_03,BEN_NW3,495765933,443588050,264908146,52177883,178679904,83797048,892317758,827799945,64517813,241409256,586390689,1280728709,1240123254,40605455,207797688,1032325566
Zoo,Ranthambore,Zoo-Ranthambore,ZSB_03,BEN_NW4,484617023,439117883,265178728,45499140,173939155,70889460,892317758,827799945,64517813,241409256,586390689,1219365724,1186222475,33143249,158691252,1027531223
Zoo,Ranthambore,Zoo-Ranthambore,ZSB_03,BEN_NW5,423790981,375452705,213667932,48338276,161784773,69781186,892317758,827799945,64517813,241409256,586390689,977809134,918585062,59224072,241966240,676618822
Zoo,Ranthambore,Zoo-Ranthambore,ZSB_03,BEN_NW55,449875429,390780739,126448776,59094690,264331963,68517901,892317758,827799945,64517813,241409256,586390689,1131174741,1073214798,57959943,534097691,539117107
Zoo,Ranthambore,Zoo-Ranthambore,ZSB_03,BEN_NW57,434417342,362895636,84639193,71521706,278256443,57130454,892317758,827799945,64517813,241409256,586390689,1180288036,1103120235,77167801,638361097,464759138
Zoo,Ranthambore,Zoo-Ranthambore,ZSB_03,BEN_NW6,399310757,352577557,180472162,46733200,172105395,82903421,892317758,827799945,64517813,241409256,586390689,992143483,946435718,45707765,248527765,697907953
Zoo,Ranthambore,Zoo-Ranthambore,ZSB_03,BEN_NW8,447636215,394392803,176729836,53243412,217662967,90424733,892317758,827799945,64517813,241409256,586390689,1196839698,1156984240,39855458,275076038,881908202
Zoo,Ranthambore,Zoo-Ranthambore,ZSB_03,BEN_NW9,497464703,444961431,246470014,52503272,198491417,81504010,892317758,827799945,64517813,241409256,586390689,1246521228,1203200533,43320695,216389572,986810961
Zoo,Ranthambore,Zoo-Ranthambore,ZSB_04,BEN_NW10,536881342,487149256,247699617,49732086,239449639,138253129,867386629,799476794,67909835,302302125,497174669,1266198710,1229664069,36534641,328923565,900740504
Zoo,Ranthambore,Zoo-Ranthambore,ZSB_04,BEN_NW11,392679127,344179543,151724121,48499584,192455422,81040824,867386629,799476794,67909835,302302125,497174669,997123987,950413379,46710608,263905963,686507416
Zoo,Ranthambore,Zoo-Ranthambore,ZSB_04,BEN_NW12,492735576,442923062,223105595,49812514,219817467,117669219,867386629,799476794,67909835,302302125,497174669,1267506856,1231795407,35711449,227052846,1004742561
Zoo,Ranthambore,Zoo-Ranthambore,ZSB_04,BEN_NW13,485695287,430369916,194303745,55325371,236066171,115392585,867386629,799476794,67909835,302302125,497174669,1183131254,1138285233,44846021,344174628,794110605
Zoo,Ranthambore,Zoo-Ranthambore,ZSB_04,BEN_NW14,487729675,434776795,226667995,52952880,208108800,99415504,867386629,799476794,67909835,302302125,497174669,1235716540,1190952996,44763544,177541519,1013411477
Zoo,Ranthambore,Zoo-Ranthambore,ZSB_04,BEN_NW17,423915124,377861565,168229337,46053559,209632228,88273562,867386629,799476794,67909835,302302125,497174669,1116321554,1085802823,30518731,256140006,829662817
Zoo,Ranthambore,Zoo-Ranthambore,ZSB_04,BEN_NW18,519011723,465538007,239616474,53473716,225921533,109725345,867386629,799476794,67909835,302302125,497174669,1339364699,1300736006,38628693,242877521,1057858485
Zoo,Ranthambore,Zoo-Ranthambore,ZSB_04,BEN_NW19,424735368,376244422,185090289,48490946,191154133,101182693,867386629,799476794,67909835,302302125,497174669,1081768306,1036331080,45437226,232322355,804008725
Zoo,Ranthambore,Zoo-Ranthambore,ZSB_04,BEN_NW20,423643116,364646269,97389565,58996847,267256704,62484942,867386629,799476794,67909835,302302125,497174669,1086271749,1022278981,63992768,541693814,480585167
Zoo,Ranthambore,Zoo-Ranthambore,ZSB_04,BEN_NW24,442767088,389431586,157770655,53335502,231660931,90139741,867386629,799476794,67909835,302302125,497174669,1159641386,1113494396,46146990,301627698,811866698
Zoo,Ranthambore,Zoo-Ranthambore,ZSB_04,BEN_NW3,469907549,414063924,193884474,55843625,220179450,80052794,867386629,799476794,67909835,302302125,497174669,1280728709,1240123254,40605455,207797688,1032325566
Zoo,Ranthambore,Zoo-Ranthambore,ZSB_04,BEN_NW4,497313167,450903778,248882472,46409389,202021306,110346353,867386629,799476794,67909835,302302125,497174669,1219365724,1186222475,33143249,158691252,1027531223
Zoo,Ranthambore,Zoo-Ranthambore,ZSB_04,BEN_NW5,411328295,364232973,170348897,47095322,193884076,88150125,867386629,799476794,67909835,302302125,497174669,977809134,918585062,59224072,241966240,676618822
Zoo,Ranthambore,Zoo-Ranthambore,ZSB_04,BEN_NW55,439101625,380960664,122738721,58140961,258221943,72064687,867386629,799476794,67909835,302302125,497174669,1131174741,1073214798,57959943,534097691,539117107
Zoo,Ranthambore,Zoo-Ranthambore,ZSB_04,BEN_NW57,462355284,393064878,95831172,69290406,297233706,77459716,867386629,799476794,67909835,302302125,497174669,1180288036,1103120235,77167801,638361097,464759138
Zoo,Ranthambore,Zoo-Ranthambore,ZSB_04,BEN_NW6,360029555,311727959,130993162,48301596,180734797,72045967,867386629,799476794,67909835,302302125,497174669,992143483,946435718,45707765,248527765,697907953
Zoo,Ranthambore,Zoo-Ranthambore,ZSB_04,BEN_NW8,515766608,466496146,237831549,49270462,228664597,127497484,867386629,799476794,67909835,302302125,497174669,1196839698,1156984240,39855458,275076038,881908202
Zoo,Ranthambore,Zoo-Ranthambore,ZSB_04,BEN_NW9,491064535,439868179,217402388,51196356,222465791,88189872,867386629,799476794,67909835,302302125,497174669,1246521228,1203200533,43320695,216389572,986810961
Zoo,Ranthambore,Zoo-Ranthambore,ZSB_05,BEN_NW10,488681283,426913722,207344798,61767561,219568924,119692607,864922054,784467789,80454265,246263826,538203963,1266198710,1229664069,36534641,328923565,900740504
Zoo,Ranthambore,Zoo-Ranthambore,ZSB_05,BEN_NW11,357470120,300402937,124432267,57067183,175970670,71296521,864922054,784467789,80454265,246263826,538203963,997123987,950413379,46710608,263905963,686507416
Zoo,Ranthambore,Zoo-Ranthambore,ZSB_05,BEN_NW12,508767054,451206185,255852487,57560869,195353698,77302884,864922054,784467789,80454265,246263826,538203963,1267506856,1231795407,35711449,227052846,1004742561
Zoo,Ranthambore,Zoo-Ranthambore,ZSB_05,BEN_NW13,457614336,396719502,173821810,60894834,222897692,98246454,864922054,784467789,80454265,246263826,538203963,1183131254,1138285233,44846021,344174628,794110605
Zoo,Ranthambore,Zoo-Ranthambore,ZSB_05,BEN_NW14,440285690,377982365,191237809,62303325,186744556,54792659,864922054,784467789,80454265,246263826,538203963,1235716540,1190952996,44763544,177541519,1013411477
Zoo,Ranthambore,Zoo-Ranthambore,ZSB_05,BEN_NW17,412691902,358498262,173733948,54193640,184764314,69193591,864922054,784467789,80454265,246263826,538203963,1116321554,1085802823,30518731,256140006,829662817
Zoo,Ranthambore,Zoo-Ranthambore,ZSB_05,BEN_NW18,508752567,446734561,246855898,62018006,199878663,96670532,864922054,784467789,80454265,246263826,538203963,1339364699,1300736006,38628693,242877521,1057858485
Zoo,Ranthambore,Zoo-Ranthambore,ZSB_05,BEN_NW19,406112210,351708407,164870900,54403803,186837507,74786800,864922054,784467789,80454265,246263826,538203963,1081768306,1036331080,45437226,232322355,804008725
Zoo,Ranthambore,Zoo-Ranthambore,ZSB_05,BEN_NW20,413071940,343471269,87351937,69600671,256119332,64575761,864922054,784467789,80454265,246263826,538203963,1086271749,1022278981,63992768,541693814,480585167
Zoo,Ranthambore,Zoo-Ranthambore,ZSB_05,BEN_NW24,484541642,427343566,202121881,57198076,225221685,101613015,864922054,784467789,80454265,246263826,538203963,1159641386,1113494396,46146990,301627698,811866698
Zoo,Ranthambore,Zoo-Ranthambore,ZSB_05,BEN_NW3,498728584,438256361,244162849,60472223,194093512,92235383,864922054,784467789,80454265,246263826,538203963,1280728709,1240123254,40605455,207797688,1032325566
Zoo,Ranthambore,Zoo-Ranthambore,ZSB_05,BEN_NW4,487698843,433140162,259919916,54558681,173220246,58725995,864922054,784467789,80454265,246263826,538203963,1219365724,1186222475,33143249,158691252,1027531223
Zoo,Ranthambore,Zoo-Ranthambore,ZSB_05,BEN_NW5,398707420,344197708,165746899,54509712,178450809,58144659,864922054,784467789,80454265,246263826,538203963,977809134,918585062,59224072,241966240,676618822
Zoo,Ranthambore,Zoo-Ranthambore,ZSB_05,BEN_NW55,440273555,374173612,114000273,66099943,260173339,77962550,864922054,784467789,80454265,246263826,538203963,1131174741,1073214798,57959943,534097691,539117107
Zoo,Ranthambore,Zoo-Ranthambore,ZSB_05,BEN_NW57,415199053,337268308,62427884,77930745,274840424,44914524,864922054,784467789,80454265,246263826,538203963,1180288036,1103120235,77167801,638361097,464759138
Zoo,Ranthambore,Zoo-Ranthambore,ZSB_05,BEN_NW6,358106206,305137944,120717836,52968262,184420108,70697762,864922054,784467789,80454265,246263826,538203963,992143483,946435718,45707765,248527765,697907953
Zoo,Ranthambore,Zoo-Ranthambore,ZSB_05,BEN_NW8,458803793,399979796,192890269,58823997,207089527,88680197,864922054,784467789,80454265,246263826,538203963,1196839698,1156984240,39855458,275076038,881908202
Zoo,Ranthambore,Zoo-Ranthambore,ZSB_05,BEN_NW9,472387240,411662781,208079761,60724459,203583020,64529242,864922054,784467789,80454265,246263826,538203963,1246521228,1203200533,43320695,216389572,986810961
Zoo,Wayanad,Zoo-Wayanad,ZSB_01,BEN_SI1,309095422,246904582,93555808,62190840,153348774,24872355,723092447,635855373,87237074,256023333,379832040,897358653,799698739,97659914,345341326,454357413
Zoo,Wayanad,Zoo-Wayanad,ZSB_01,BEN_SI11,194879975,158832947,43574206,36047028,115258741,21063377,723092447,635855373,87237074,256023333,379832040,641166204,612648765,28517439,241001807,371646958
Zoo,Wayanad,Zoo-Wayanad,ZSB_01,BEN_SI2,207218747,182274861,84812020,24943886,97462841,29283921,723092447,635855373,87237074,256023333,379832040,650993225,648515374,2477851,140667619,507847755
Zoo,Wayanad,Zoo-Wayanad,ZSB_01,BEN_SI3,277971060,212591898,56438400,65379162,156153498,23057002,723092447,635855373,87237074,256023333,379832040,931565359,847325564,84239795,345974583,501350981
Zoo,Wayanad,Zoo-Wayanad,ZSB_01,BEN_SI4,313086524,240484791,61445237,72601733,179039554,19182674,723092447,635855373,87237074,256023333,379832040,1109312253,1030580255,78731998,302255092,728325163
Zoo,Wayanad,Zoo-Wayanad,ZSB_01,BEN_SI6,307238833,244411245,92842579,62827588,151568666,42695266,723092447,635855373,87237074,256023333,379832040,951080464,864453508,86626956,319674486,544779022
Zoo,Wayanad,Zoo-Wayanad,ZSB_01,BEN_SI7,281560930,214217833,60947049,67343097,153270784,22757145,723092447,635855373,87237074,256023333,379832040,942430262,853584663,88845599,335397181,518187482
Zoo,Wayanad,Zoo-Wayanad,ZSB_01,BEN_SI8,312093577,238052189,61154892,74041388,176897297,22620046,723092447,635855373,87237074,256023333,379832040,1108177315,1029030472,79146843,300308119,728722353
Zoo,Wayanad,Zoo-Wayanad,ZSB_01,BEN_SI9,287435251,221744566,75423679,65690685,146320887,27144241,723092447,635855373,87237074,256023333,379832040,849233213,745820153,103413060,339499389,406320764
Zoo,Wayanad,Zoo-Wayanad,ZSB_02,BEN_SI1,354782216,282658720,83936035,72123496,198722685,48130050,942790346,865053483,77736863,260820720,604232763,897358653,799698739,97659914,345341326,454357413
Zoo,Wayanad,Zoo-Wayanad,ZSB_02,BEN_SI11,240239079,203807073,67624707,36432006,136182366,41338295,942790346,865053483,77736863,260820720,604232763,641166204,612648765,28517439,241001807,371646958
Zoo,Wayanad,Zoo-Wayanad,ZSB_02,BEN_SI2,256663051,231883693,115238437,24779358,116645256,49583643,942790346,865053483,77736863,260820720,604232763,650993225,648515374,2477851,140667619,507847755
Zoo,Wayanad,Zoo-Wayanad,ZSB_02,BEN_SI3,378318587,313522126,119716247,64796461,193805879,59098643,942790346,865053483,77736863,260820720,604232763,931565359,847325564,84239795,345974583,501350981
Zoo,Wayanad,Zoo-Wayanad,ZSB_02,BEN_SI4,471550169,404523538,188580428,67026631,215943110,71739785,942790346,865053483,77736863,260820720,604232763,1109312253,1030580255,78731998,302255092,728325163
Zoo,Wayanad,Zoo-Wayanad,ZSB_02,BEN_SI6,396645943,329303337,134735442,67342606,194567895,60008335,942790346,865053483,77736863,260820720,604232763,951080464,864453508,86626956,319674486,544779022
Zoo,Wayanad,Zoo-Wayanad,ZSB_02,BEN_SI7,384677900,317344545,123364722,67333355,193979823,57194387,942790346,865053483,77736863,260820720,604232763,942430262,853584663,88845599,335397181,518187482
Zoo,Wayanad,Zoo-Wayanad,ZSB_02,BEN_SI8,471244912,404402213,187605942,66842699,216796271,72651621,942790346,865053483,77736863,260820720,604232763,1108177315,1029030472,79146843,300308119,728722353
Zoo,Wayanad,Zoo-Wayanad,ZSB_02,BEN_SI9,351407523,281523562,95230127,69883961,186293435,54994992,942790346,865053483,77736863,260820720,604232763,849233213,745820153,103413060,339499389,406320764
Zoo,Wayanad,Zoo-Wayanad,ZSB_03,BEN_SI1,340672122,272548972,70263767,68123150,202285205,21408570,892317758,827799945,64517813,241409256,586390689,897358653,799698739,97659914,345341326,454357413
Zoo,Wayanad,Zoo-Wayanad,ZSB_03,BEN_SI11,262793260,233450242,106855055,29343018,126595187,54895609,892317758,827799945,64517813,241409256,586390689,641166204,612648765,28517439,241001807,371646958
Zoo,Wayanad,Zoo-Wayanad,ZSB_03,BEN_SI2,271241109,250696218,130603089,20544891,120093129,44548605,892317758,827799945,64517813,241409256,586390689,650993225,648515374,2477851,140667619,507847755
Zoo,Wayanad,Zoo-Wayanad,ZSB_03,BEN_SI3,361814711,301484950,117835707,60329761,183649243,54511936,892317758,827799945,64517813,241409256,586390689,931565359,847325564,84239795,345974583,501350981
Zoo,Wayanad,Zoo-Wayanad,ZSB_03,BEN_SI4,418123674,357951148,148159802,60172526,209791346,60016902,892317758,827799945,64517813,241409256,586390689,1109312253,1030580255,78731998,302255092,728325163
Zoo,Wayanad,Zoo-Wayanad,ZSB_03,BEN_SI6,380401097,317255316,135744919,63145781,181510397,64886711,892317758,827799945,64517813,241409256,586390689,951080464,864453508,86626956,319674486,544779022
Zoo,Wayanad,Zoo-Wayanad,ZSB_03,BEN_SI7,366752267,304488473,120650836,62263794,183837637,53640875,892317758,827799945,64517813,241409256,586390689,942430262,853584663,88845599,335397181,518187482
Zoo,Wayanad,Zoo-Wayanad,ZSB_03,BEN_SI8,417132665,356343522,144783094,60789143,211560428,56132016,892317758,827799945,64517813,241409256,586390689,1108177315,1029030472,79146843,300308119,728722353
Zoo,Wayanad,Zoo-Wayanad,ZSB_03,BEN_SI9,339748088,274054472,91181294,65693616,182873178,45968217,892317758,827799945,64517813,241409256,586390689,849233213,745820153,103413060,339499389,406320764
Zoo,Wayanad,Zoo-Wayanad,ZSB_04,BEN_SI1,322246870,254490294,66299205,67756576,188191089,40093807,867386629,799476794,67909835,302302125,497174669,897358653,799698739,97659914,345341326,454357413
Zoo,Wayanad,Zoo-Wayanad,ZSB_04,BEN_SI11,247479682,216779934,72750928,30699748,144029006,36440877,867386629,799476794,67909835,302302125,497174669,641166204,612648765,28517439,241001807,371646958
Zoo,Wayanad,Zoo-Wayanad,ZSB_04,BEN_SI2,260283168,236555869,106428468,23727299,130127401,53838428,867386629,799476794,67909835,302302125,497174669,650993225,648515374,2477851,140667619,507847755
Zoo,Wayanad,Zoo-Wayanad,ZSB_04,BEN_SI3,334287919,271350720,68223064,62937199,203127656,48225601,867386629,799476794,67909835,302302125,497174669,931565359,847325564,84239795,345974583,501350981
Zoo,Wayanad,Zoo-Wayanad,ZSB_04,BEN_SI4,411209392,349176348,139033597,62033044,210142751,73941223,867386629,799476794,67909835,302302125,497174669,1109312253,1030580255,78731998,302255092,728325163
Zoo,Wayanad,Zoo-Wayanad,ZSB_04,BEN_SI6,344585788,278810705,101201318,65775083,177609387,72743962,867386629,799476794,67909835,302302125,497174669,951080464,864453508,86626956,319674486,544779022
Zoo,Wayanad,Zoo-Wayanad,ZSB_04,BEN_SI7,339826232,274342685,64516224,65483547,209826461,48011188,867386629,799476794,67909835,302302125,497174669,942430262,853584663,88845599,335397181,518187482
Zoo,Wayanad,Zoo-Wayanad,ZSB_04,BEN_SI8,410415005,348516290,136444605,61898715,212071685,73306026,867386629,799476794,67909835,302302125,497174669,1108177315,1029030472,79146843,300308119,728722353
Zoo,Wayanad,Zoo-Wayanad,ZSB_04,BEN_SI9,319610297,253018646,65843305,66591651,187175341,42695887,867386629,799476794,67909835,302302125,497174669,849233213,745820153,103413060,339499389,406320764
Zoo,Wayanad,Zoo-Wayanad,ZSB_05,BEN_SI1,369469192,302495150,126316456,66974042,176178694,44124137,864922054,784467789,80454265,246263826,538203963,897358653,799698739,97659914,345341326,454357413
Zoo,Wayanad,Zoo-Wayanad,ZSB_05,BEN_SI11,236985640,198553134,79886565,38432506,118666569,37420952,864922054,784467789,80454265,246263826,538203963,641166204,612648765,28517439,241001807,371646958
Zoo,Wayanad,Zoo-Wayanad,ZSB_05,BEN_SI2,257018329,231471443,115419756,25546886,116051687,31826443,864922054,784467789,80454265,246263826,538203963,650993225,648515374,2477851,140667619,507847755
Zoo,Wayanad,Zoo-Wayanad,ZSB_05,BEN_SI3,357050035,288210713,112220589,68839322,175990124,38180388,864922054,784467789,80454265,246263826,538203963,931565359,847325564,84239795,345974583,501350981
Zoo,Wayanad,Zoo-Wayanad,ZSB_05,BEN_SI4,440781851,372661705,180171280,68120146,192490425,71718472,864922054,784467789,80454265,246263826,538203963,1109312253,1030580255,78731998,302255092,728325163
Zoo,Wayanad,Zoo-Wayanad,ZSB_05,BEN_SI6,369334857,302141698,129575214,67193159,172566484,50010132,864922054,784467789,80454265,246263826,538203963,951080464,864453508,86626956,319674486,544779022
Zoo,Wayanad,Zoo-Wayanad,ZSB_05,BEN_SI7,361766461,290274232,115256966,71492229,175017266,42022936,864922054,784467789,80454265,246263826,538203963,942430262,853584663,88845599,335397181,518187482
Zoo,Wayanad,Zoo-Wayanad,ZSB_05,BEN_SI8,439891282,373266913,179325299,66624369,193941614,67292306,864922054,784467789,80454265,246263826,538203963,1108177315,1029030472,79146843,300308119,728722353
Zoo,Wayanad,Zoo-Wayanad,ZSB_05,BEN_SI9,332641972,263881298,89856302,68760674,174024996,35436507,864922054,784467789,80454265,246263826,538203963,849233213,745820153,103413060,339499389,406320764
Zoo,Zoo,Zoo-Zoo,ZSB_01,ZSB_02,344565501,277700292,103965618,66865209,173734674,22084091,723092447,635855373,87237074,256023333,379832040,942790346,865053483,77736863,260820720,604232763
Zoo,Zoo,Zoo-Zoo,ZSB_01,ZSB_03,347865454,286755072,127949031,61110382,158806041,28220326,723092447,635855373,87237074,256023333,379832040,892317758,827799945,64517813,241409256,586390689
Zoo,Zoo,Zoo-Zoo,ZSB_01,ZSB_04,312940115,249091686,79355694,63848429,169735992,35396066,723092447,635855373,87237074,256023333,379832040,867386629,799476794,67909835,302302125,497174669
Zoo,Zoo,Zoo-Zoo,ZSB_01,ZSB_05,298441217,234348911,68379874,64092306,165969037,23486918,723092447,635855373,87237074,256023333,379832040,864922054,784467789,80454265,246263826,538203963
Zoo,Zoo,Zoo-Zoo,ZSB_02,ZSB_01,344565501,277700292,103965618,66865209,173734674,22084091,942790346,865053483,77736863,260820720,604232763,723092447,635855373,87237074,256023333,379832040
Zoo,Zoo,Zoo-Zoo,ZSB_02,ZSB_03,516797534,455230152,243312567,61567382,211917585,94941595,942790346,865053483,77736863,260820720,604232763,892317758,827799945,64517813,241409256,586390689
Zoo,Zoo,Zoo-Zoo,ZSB_02,ZSB_04,526058653,461830080,234550482,64228573,227279598,117823303,942790346,865053483,77736863,260820720,604232763,867386629,799476794,67909835,302302125,497174669
Zoo,Zoo,Zoo-Zoo,ZSB_02,ZSB_05,452908591,383193394,199671269,69715197,183522125,73392400,942790346,865053483,77736863,260820720,604232763,864922054,784467789,80454265,246263826,538203963
Zoo,Zoo,Zoo-Zoo,ZSB_03,ZSB_01,347865454,286755072,127949031,61110382,158806041,28220326,892317758,827799945,64517813,241409256,586390689,723092447,635855373,87237074,256023333,379832040
Zoo,Zoo,Zoo-Zoo,ZSB_03,ZSB_02,516797534,455230152,243312567,61567382,211917585,94941595,892317758,827799945,64517813,241409256,586390689,942790346,865053483,77736863,260820720,604232763
Zoo,Zoo,Zoo-Zoo,ZSB_03,ZSB_04,478402890,420995337,200736195,57407553,220259142,87632448,892317758,827799945,64517813,241409256,586390689,867386629,799476794,67909835,302302125,497174669
Zoo,Zoo,Zoo-Zoo,ZSB_03,ZSB_05,427617996,363694094,182578503,63923902,181115591,47149779,892317758,827799945,64517813,241409256,586390689,864922054,784467789,80454265,246263826,538203963
Zoo,Zoo,Zoo-Zoo,ZSB_04,ZSB_01,312940115,249091686,79355694,63848429,169735992,35396066,867386629,799476794,67909835,302302125,497174669,723092447,635855373,87237074,256023333,379832040
Zoo,Zoo,Zoo-Zoo,ZSB_04,ZSB_02,526058653,461830080,234550482,64228573,227279598,117823303,867386629,799476794,67909835,302302125,497174669,942790346,865053483,77736863,260820720,604232763
Zoo,Zoo,Zoo-Zoo,ZSB_04,ZSB_03,478402890,420995337,200736195,57407553,220259142,87632448,867386629,799476794,67909835,302302125,497174669,892317758,827799945,64517813,241409256,586390689
Zoo,Zoo,Zoo-Zoo,ZSB_04,ZSB_05,398664068,334974054,145315762,63690014,189658292,58943961,867386629,799476794,67909835,302302125,497174669,864922054,784467789,80454265,246263826,538203963
Zoo,Zoo,Zoo-Zoo,ZSB_05,ZSB_01,298441217,234348911,68379874,64092306,165969037,23486918,864922054,784467789,80454265,246263826,538203963,723092447,635855373,87237074,256023333,379832040
Zoo,Zoo,Zoo-Zoo,ZSB_05,ZSB_02,452908591,383193394,199671269,69715197,183522125,73392400,864922054,784467789,80454265,246263826,538203963,942790346,865053483,77736863,260820720,604232763
Zoo,Zoo,Zoo-Zoo,ZSB_05,ZSB_03,427617996,363694094,182578503,63923902,181115591,47149779,864922054,784467789,80454265,246263826,538203963,892317758,827799945,64517813,241409256,586390689
Zoo,Zoo,Zoo-Zoo,ZSB_05,ZSB_04,398664068,334974054,145315762,63690014,189658292,58943961,864922054,784467789,80454265,246263826,538203963,867386629,799476794,67909835,302302125,497174669
